AACATTGATGCTACTAAACGC	AACATTGATGCTACTAACCGC
CCCCTCCCAGTAGTTCTGCTA	CCCCTCCCAGTAGTTTTGCTA
AAAGCAAAGTTAATAGCGACG	AAAGCAAAGTTAATTGCGACG
GCTGGATTTCTGTAGCTTATA	GCTGGATTTCTGTAGCTGATA
ATGTTCAAGAAAACGATCCAC	ATGTTCAAGATAACGATCCAC
AGTATAGATCCCCCCCCCTAA	AGTATAGATCCCACCCCCTAA
TACATTCGGTACGCAGAGGGA	TACATTCGGTACGTAGAGGGA
ACTGGAATATCGGGAGACCCA	ACTGGAATATCGGGAGACCCC
TGTTGACATGTATAGCCAACA	TGTTGACATGTATAGGCAACA
GTGAGAAGTTCCCTCTGCGTA	GTGAGAAGTTCCCTCTACGTA
CAGAGAAACACCCTGACGCAC	CAGAGAAACACCCTGTCGCAC
AACCTGTAATTCTAAGCACTA	AACCTGTAATTATAAGCACTA
ATGCCCCTGTCCACACGATAC	ATGCCCCTGTCCACACGAGAC
AAGAAGCGATCAGTTCGCGAT	AAGAAGCGATCAGTTCGCGGT
GGTTAGCGGTGCCAATGCTCA	GGTTAGCGGTGCTAATGCTCA
AGTTCCCTCTGCGTACCGAAT	AGTTCCCTCTACGTACCGAAT
GTACTTAGATAGTTAGACTTA	GTACTTAGATAGTTAGACCTA
CCACATATATATTGTAAACCA	CCACATATATATTATAAACCA
GTGTACTTTGAGGGTTATGCA	GTGTACTTTGTGGGTTATGCA
ACAGTGGAACGGAGTGCTCCC	ACAGTGGAACGGATTGCTCCC
CCTGGGTGAGCATTGGCACCG	CCTGGGTGAGCATTAGCACCG
GCCCACAGTATAGATCCCCCC	GCCCACAGTATAGATCCCACC
AAGTGACTATACGGTAGCAAA	AAGTGACTATACGGTAGCAGA
GCACATCTTGGTCATGGTCCC	GCACATCTTGGTCATGGTACC
CTTGCTACTCTAGTCGGATAA	CTTGCTACTCGAGTCGGATAA
CAACTAGGGGTAACCACCCTC	CAACTAGGGGTAACAACCCTC
ACCCTAATACCGTCGCTATTA	ACCCTAATACCGTCGCAATTA
AGTGGAACGGATTGCTCCCCC	AGTGGAACGGAGTGCTCCCCC
AGAATCTTAGTGCATAACCCT	AGAATCTTAGTGCATAACCCA
GGGCTTCAGTTGAGATGAAAC	GGGCTTCAGTTGAGATGAAAA
GGTGAGCATTGGCACCGCTAA	GGTGAGCATTAGCACCGCTAA
CCTAACCTGTAATTCTAAGCA	CCTAACCTGTAATTATAAGCA
CGCGCTTGGTATATTGTTGGC	CGCGCTTGGTATATTGTTGCC
GGGTGGATCGTTTTCTTGAAC	GGGTGGATCGTTATCTTGAAC
CTCTGTCACGAGTTAGCAGTA	CTCTGTCACGAGATAGCAGTA
CTGATATCTGTACAAATTCGC	CTGATATCTGTACAAATTTGC
TCCGACAACACTTGCCAGCGA	TCCGACAACACTTGCCAGCCA
ACGACTGACTTGTATTCTAGA	ACGACTGACTCGTATTCTAGA
CAGTCGTCGGTCCCAGAAACA	CAGTCGTCGGTACCAGAAACA
GCACCGCTAATCTCGCAAGCC	GCACCGCTAACCTCGCAAGCC
ACGTGGCACAGTGGAACGGAG	ACGTGGCACAGTGGAACGGAT
GTCGTCTGCGAAGTCCTTTCA	GTCGTCTGCGAAGCCCTTTCA
ATTTTCTTACGCAGTCTGCCG	ATTTTCTTACGAAGTCTGCCG
ACATATGAAAAGGGTGAGGAT	ACATATGAAAAGGGTGATGAT
GTTGGGACGTATATCTGAATA	GTTGGGACGTATATGTGAATA
CACTATGGCGACCGCGTTTAC	CACTATGGCGACCGCGTTTCC
CCCTAGTTGAGGAACCGCCAC	CCCTAGTTGAGGAACCGCCAA
AGAACATTGATGCTACTAAAC	AGAACATTGATGCTACTAACC
TAGTGCGGGTACACGCGGTGA	TAGTGCGGGTACACGTGGTGA
CATTCATGTAACAAGAGACCG	CATTCATGTAACAAGAGATCG
ACCACATATATATTGTAAACC	ACCACATATATATTATAAACC
ACCTTGCCATCGCTGGCAAGT	ACCTTGCCATGGCTGGCAAGT
ATAGGAGCGTCACACTGGAAT	ATAGGAGCGTGACACTGGAAT
AGCATATGGTTTGAATAGATC	AGCATATGGTTTGAATTGATC
CACACGCCATTATTGTACTCA	CACACGCCATTGTTGTACTCA
CGCTGCAGCGGCCCCCTTGAG	CGCTGCAGCGGCCACCTTGAG
AGAAGCGATCAGTTCGCGATC	AGAAGCGATCAGTTCGCGGTC
GGGGGGATTCTTGCTACTCTA	GGGGGGATTCTTGCTACTCGA
AGCCCACAGTATAGATCCCCC	AGCCCACAGTATAGATCCCAC
CTAGCCGCGACGTTTTGATAA	CTAGCCGCGACGTTTCGATAA
CAGTCCAGCTTTTAAATGGAC	CAGTCCAGCTTTTTAATGGAC
ATGGCGACCGCGTTTACCCTG	ATGGCGACCGCGTTTCCCCTG
CCCTAACCTGTAATTCTAAGC	CCCTAACCTGTAATTATAAGC
AGCGGTTCTCCGGCTGAATAG	AGCGGTTCTCCGGCTGAATAA
ACTATACGGTAGCAAAACTAC	ACTATACGGTAGCAGAACTAC
ATTGATGCTACTAAACGCCGC	ATTGATGCTACTAACCGCCGC
CTAGTTGAGGAACCGCCAACC	CTAGTTGAGGAACCGCCACCC
ACAGTACGGGCGCCCAAACGT	ACAGTACGGGCGCCCAAACGA
GCGGTGCAACTCATCGCATAC	GCGGTGCAACTCGTCGCATAC
ACATTCATGTAACAAGAGACC	ACATTCATGTAACAAGAGATC
GACGGTTACTCGTGCTTCGAA	GACGGTTACTCGTGATTCGAA
ATAGTTAGACTTATTCAGCCG	ATAGTTAGACCTATTCAGCCG
GATAGGGTCCTCATTCGAAGC	GATAGGGTCCTCATTCGAATC
ACTGAGTACAACAATGGCGTG	ACTGAGTACAATAATGGCGTG
CCTAATGAGTGCGGGCTTCGC	CCTAATGAGTGCCGGCTTCGC
AAAGAACCACATATATATTGT	AAAGAACCACATATATATTAT
CACGTGTTGACATGTATAGCC	CACGTGTTGACATGTATAGGC
ATGGCTGCCAACTCCTTTTGG	ATGGCTGCCAACCCCTTTTGG
ATACGACAATTACTTTGACAG	ATACGACAATTACTTGGACAG
GTATACGACAATTACTTTGAC	GTATACGACAATTACTTGGAC
TACTCCCCGTCACAATTGTCA	TACTCCCCGTCCCAATTGTCA
GTCGCAGCTCGCGTCCTTATA	GTCGCAGCTCGCGTCCTAATA
CCGGCAGAGAAACACCCTGAC	CCGGCAGAGAAACACCCTGTC
CCGGATAAGCACATAAGAGCA	CCGGATAAGCATATAAGAGCA
ATAGTGCGGGTACACGCGGTG	ATAGTGCGGGTACACGTGGTG
AGTCGTCGGTCCCAGAAACAG	AGTCGTCGGTACCAGAAACAG
CCTAATACCGTCGCTATTAAC	CCTAATACCGTCGCAATTAAC
ATGGTTGAGAGGGTGGTTACC	ATGGTTGAGAGGGTTGTTACC
CATATATATTGTAAACCATGC	CATATATATTATAAACCATGC
CGCCGCGTACTTAGTGCGACA	CGCCGCGTACTTAGTGCGTCA
GAAGTTCCCTCTGCGTACCGA	GAAGTTCCCTCTACGTACCGA
GTGTTGACATGTATAGCCAAC	GTGTTGACATGTATAGGCAAC
TACTTGGCAAACCCTGATCTA	TACTTGGCAAACCCTGATCAA
AGTTGAGATGAAACTAATGCG	AGTTGAGATGAAAATAATGCG
CAGGTTAGGGGGGGGGATCTA	CAGGTTAGGGGGTGGGATCTA
AGGAACCGCCAACCTAACTAC	AGGAACCGCCACCCTAACTAC
TCCAGCTTTTAAATGGACGCA	TCCAGCTTTTTAATGGACGCA
GAAAGCAAAGTTAATAGCGAC	GAAAGCAAAGTTAATTGCGAC
AATACGATACTCAATCACCTG	AATACGATACCCAATCACCTG
GCCTACCAAAAGGAGTTGGCA	GCCTACCAAAAGGGGTTGGCA
ACCGCAAACTGGAAATTTTTA	ACCGCAAACTGGAAAATTTTA
CTTCAGTTGAGATGAAACTAA	CTTCAGTTGAGATGAAAATAA
CTGGGAGGGGGGGGGGAGCAC	CTGGGAGGGGGGGGGGAGCAA
CCCTACGCAGCTACTGATACG	CCCTACGCAGCTACTGAAACG
GATAGTTAGACTTATTCAGCC	GATAGTTAGACCTATTCAGCC
AAAGGAATCTCTCTCAAATTT	AAAGGAATCTCTCTCATATTT
CACGCGGTGGGTATTCACATA	CACGCGGTGGGTATTCAGATA
GTTGAGGAACCGCCAACCTAA	GTTGAGGAACCGCCACCCTAA
CTGCAGCGGCCCCCTTGAGAA	CTGCAGCGGCCACCTTGAGAA
CTAACCTGTAATTCTAAGCAC	CTAACCTGTAATTATAAGCAC
GCTAGTATGCGACGAGTTGCA	GCTAGTATGCGATGAGTTGCA
CATAACTAAAGTTCTGTCCAA	CATAACTAAAGTTCTGTCAAA
ATCTGTACAAATTTGCCCAAA	ATCTGTACAAATTCGCCCAAA
CCCTAATGAGTGCGGGCTTCG	CCCTAATGAGTGCCGGCTTCG
AGCCTACCAAAAGGAGTTGGC	AGCCTACCAAAAGGGGTTGGC
CACGAGTAACCGTCATGGAGG	CACGAGTAACCGTCATCGAGG
TGCTTTGGGCAAATTTGTACA	TGCTTTGGGCGAATTTGTACA
GTTCTTTACTCCCCGTCCCAA	GTTCTTTACTCCCCGTCACAA
CTTGCAGACTAGGGACCATGA	CTTGCAGACTAGGTACCATGA
ACCTTGATTTATCCGACTAGA	ACCTTGATTTATCCGACTCGA
CTTGCGAGGTTAGCGGTGCCA	CTTGCGAGGTTAGCGGTGCTA
CGGGGTTTGCTTAAATATGAG	CGGGGTTTGCTTAAATTTGAG
ACCGACGACTGACTTGTATTC	ACCGACGACTGACTCGTATTC
AAAGTTCTGTCCAAGTAATTG	AAAGTTCTGTCAAAGTAATTG
CACTACTTAGGGTAAGGAGGA	CACTACTTAGGGTAAGGATGA
CGGTTATTTTCTTACGAAGTC	CGGTTATTTTCTTACGCAGTC
GATTGCACACTGAGTACAATA	GATTGCACACTGAGTACAACA
ACGACAATTACTTGGACAGAA	ACGACAATTACTTTGACAGAA
CGAGGTTAGCGGTGCCAATGC	CGAGGTTAGCGGTGCTAATGC
AAACTGGAAAATTTTATGGAG	AAACTGGAAATTTTTATGGAG
CGGGAGACTCCCCCAAAAAAG	CGGGAGACTCCCCCAAAAGAG
GGGGTTTGCTTAAATATGAGA	GGGGTTTGCTTAAATTTGAGA
GAAAAGGGTGAGGATCCAGTA	GAAAAGGGTGATGATCCAGTA
CACATATGAAAAGGGTGAGGA	CACATATGAAAAGGGTGATGA
CGTCGCAGGGTAAACGCGGTC	CGTCGCAGGGGAAACGCGGTC
ATATCGGCAGACTGCGTAAGA	ATATCGGCAGACTTCGTAAGA
CATTGATGCTACTAAACGCCG	CATTGATGCTACTAACCGCCG
AAACACCCTGACGCACTAAGT	AAACACCCTGTCGCACTAAGT
CCCACAGTATAGATCCCCCCC	CCCACAGTATAGATCCCACCC
AAATGTATGGCTGCCAACTCC	AAATGTATGGCTGCCAACCCC
GCGGGGTTTGCTTAAATATGA	GCGGGGTTTGCTTAAATTTGA
AACTAAAGTTCTGTCCAAGTA	AACTAAAGTTCTGTCAAAGTA
GTTACTCTGTGCGTCCATTTA	GTTACTCTGTGCGTCCATTAA
CTAGTATGCGATGAGTTGCAC	CTAGTATGCGACGAGTTGCAC
GCGCGGGTCTGTTTCTGGGAC	GCGCGGGTCTGTTTCTGGTAC
CGCGAACCCTTTTTTGGGGGA	CGCGAACCCTCTTTTGGGGGA
CTCGTGAGAAGTTCCCTCTAC	CTCGTGAGAAGTTCCCTCTGC
CGTCTGCGAAGTCCTTTCATC	CGTCTGCGAAGCCCTTTCATC
GACTCAAACACTTACCTTGCC	GACTCAAACATTTACCTTGCC
CATTCGGTACGCAGAGGGAAC	CATTCGGTACGTAGAGGGAAC
CACAGTATAGATCCCCCCCCC	CACAGTATAGATCCCACCCCC
ACATCCGTCGGTGCGTATCAG	ACATCCGTCGGTGCGTTTCAG
AGCACGCGGTGGGTATTCACA	AGCACGCGGTGGGTATTCAGA
CCGGCTGAATAAGTCTAACTA	CCGGCTGAATAGGTCTAACTA
GGGTCTGTTTCTGGGACCGAC	GGGTCTGTTTCTGGTACCGAC
CCTCCCAGTAGTTCTGCTACC	CCTCCCAGTAGTTTTGCTACC
CAGTATAGATCCCCCCCCCTA	CAGTATAGATCCCACCCCCTA
GCGACCGCGTTTACCCTGCGA	GCGACCGCGTTTCCCCTGCGA
AGTTAAATGACGTTCTCAAGG	AGTTAAATGAGGTTCTCAAGG
GCCCTAGGAATACACCTCGAA	GCCCTAGGAACACACCTCGAA
AGGGTAAGGATGAATCGGAAA	AGGGTAAGGAGGAATCGGAAA
ACCGGATAAGCACATAAGAGC	ACCGGATAAGCATATAAGAGC
CAGTTGAGATGAAACTAATGC	CAGTTGAGATGAAAATAATGC
CTGTACAAATTCGCCCAAAGC	CTGTACAAATTTGCCCAAAGC
CAAGGATCAGGTGATTGAGTA	CAAGGATCAGGTGATTGGGTA
CAATCACTTGCAGACTAGGGA	CAATCACTTGCAGACTAGGTA
TACATCCGTCGGTGCGTATCA	TACATCCGTCGGTGCGTTTCA
AATGTATGGCTGCCAACTCCT	AATGTATGGCTGCCAACCCCT
CTGTAGCTGATAATATAAGGA	CTGTAGCTGATAATATTAGGA
CCTGTCTAGAATACAAGTCAG	CCTGTCTAGAATACGAGTCAG
TATGAAAAGGGTGAGGATCCA	TATGAAAAGGGTGATGATCCA
ACAGTATAGATCCCCCCCCCT	ACAGTATAGATCCCACCCCCT
CGACCGCGTTTACCCTGCGAC	CGACCGCGTTTCCCCTGCGAC
CCTGCTCGTGACAATTGTGAC	CCTGCTCGTGACAATTGGGAC
CGTGCTCTTATGTGCTTATCC	CGTGCTCTTATATGCTTATCC
CCTTGATTTATCCGACTAGAG	CCTTGATTTATCCGACTCGAG
AAGTAATTGTCGTATACAGTA	AAGTAATTGTCGTATACAGTC
CTTAGTGCATAACCCACAAAG	CTTAGTGCATAACCCTCAAAG
ACCCACCAGGTTGGTGGTTCA	ACCCACCAGGTTGGTGGTTGA
GTAAAAGGCGATAAATGCATA	GTAAAAGGCGATAAACGCATA
GCGGGTGGATCGTTTTCTTGA	GCGGGTGGATCGTTATCTTGA
CGGAGGACCCTGCTCGAGACA	CGGAGGACCCTGCTCGTGACA
CTCCCCCAAAAGAGGGTTCGC	CTCCCCCAAAAAAGGGTTCGC
ACGAATCTATATATCCGCGGC	ACGAATCTATATATACGCGGC
AGCTGATAATATAAGGACGCG	AGCTGATAATATTAGGACGCG
CGATGAAAGGGCTTCGCAGAC	CGATGAAAGGACTTCGCAGAC
ACCTGTAATTCTAAGCACTAT	ACCTGTAATTATAAGCACTAT
GAATCTCTCTCAAATTTAAGC	GAATCTCTCTCATATTTAAGC
CGTTATCGCCCTAGGAATACA	CGTTATCGCCCTAGGAACACA
GTGGACCGGAGCAAGCGCTGA	GTGGACCGGAGCAAGCGCAGA
CGGAATAACATAGTGCTTAGA	CGGAATAACATAGTGCTTATA
AGTAAAAGGCGATAAATGCAT	AGTAAAAGGCGATAAACGCAT
AAGGCGATAAATGCATAACAG	AAGGCGATAAACGCATAACAG
CCCATCTCCATAAAATTTTCC	CCCATCTCCATAAAAATTTCC
ACCATGCGGCTGGTACCGAGG	ACCATGCGGCTGGTACCGAGT
AGTGCAAAGAAGTTCTTTTGA	AGTGCAAAGAAGTTCCTTTGA
AGTCACCTGTCTAGAATACAA	AGTCACCTGTCTAGAATACGA
ATGAAAAGGGTGAGGATCCAG	ATGAAAAGGGTGATGATCCAG
CCAGTCCAGCTTTTAAATGGA	CCAGTCCAGCTTTTTAATGGA
CTGCAAGGACTCCACGGTCTC	CTGCAAGGACTCCACGGCCTC
GTACTCTGTCACGAGATAGCA	GTACTCTGTCACGAGTTAGCA
CGGCGGACTCAAACACTTACC	CGGCGGACTCAAACATTTACC
ATCGATTATCAAAACGTCGCG	ATCGATTATCGAAACGTCGCG
TGAAGTTAAATGACGTTCTCA	TGAAGTTAAATGAGGTTCTCA
AGCTCTTAGCGGTGCAACTCA	AGCTCTTAGCGGTGCAACTCG
GTATAGATCCCCCCCCCTAAC	GTATAGATCCCACCCCCTAAC
ACACTACTTAGGGTAAGGAGG	ACACTACTTAGGGTAAGGATG
AACGACGGCGGACTCAAACAT	AACGACGGCGGACTCAAACAC
CTTTCGATGAAAGGACTTCGC	CTTTCGATGAAAGGGCTTCGC
CGCCCTAGGAATACACCTCGA	CGCCCTAGGAACACACCTCGA
AACTAGGGGTAACCACCCTCT	AACTAGGGGTAACAACCCTCT
TACGACAATTACTTGGACAGA	TACGACAATTACTTTGACAGA
ACCTGTCTAGAATACAAGTCA	ACCTGTCTAGAATACGAGTCA
CCCGATATTCCAGTGTGACGC	CCCGATATTCCAGTGTCACGC
CTGTCGCAGCTCGCGTCCTTA	CTGTCGCAGCTCGCGTCCTAA
AAGCATATGGTTTGAATAGAT	AAGCATATGGTTTGAATTGAT
GATATCTGTACAAATTTGCCC	GATATCTGTACAAATTCGCCC
AGTGGACCGGAGCAAGCGCTG	AGTGGACCGGAGCAAGCGCAG
AGCGGGTGGATCGTTTTCTTG	AGCGGGTGGATCGTTATCTTG
CTTGGTATATTGTTGGCTATA	CTTGGTATATTGTTGCCTATA
ACGCGGTGGGTATTCACATAT	ACGCGGTGGGTATTCAGATAT
CGATATTCCAGTGTGACGCTC	CGATATTCCAGTGTCACGCTC
ATACGGTAGCAGAACTACTGG	ATACGGTAGCAAAACTACTGG
GAAGTTAAATGACGTTCTCAA	GAAGTTAAATGAGGTTCTCAA
AAGCCCACAGTATAGATCCCC	AAGCCCACAGTATAGATCCCA
GAATGTTCAAGAAAACGATCC	GAATGTTCAAGATAACGATCC
TATAACCGGATAAGCATATAA	TATAACCGGATAAGCACATAA
ACACATATGAAAAGGGTGAGG	ACACATATGAAAAGGGTGATG
ATCGGGAGACCCAGTCCGTCC	ATCGGGAGACCCCGTCCGTCC
ATCATAACTAAAGTTCTGTCA	ATCATAACTAAAGTTCTGTCC
CGCCCAAACGTGAGAGGTGAG	CGCCCAAACGAGAGAGGTGAG
GCAAACCCTGATCTATTCAAA	GCAAACCCTGATCAATTCAAA
ACATAGTGCTTAGAATTACAG	ACATAGTGCTTATAATTACAG
CGCGGTGGGTATTCACATATA	CGCGGTGGGTATTCAGATATA
CCCTGTCCACACGATACTGTA	CCCTGTCCACACGAGACTGTA
GCGGAGGACCCTGCTCGAGAC	GCGGAGGACCCTGCTCGTGAC
GCATATGGTTTGAATAGATCA	GCATATGGTTTGAATTGATCA
CTTAGCGGTGCAACTCATCGC	CTTAGCGGTGCAACTCGTCGC
ACTCTGTCACGAGATAGCAGT	ACTCTGTCACGAGTTAGCAGT
ACATGTATAGCCAACAATATA	ACATGTATAGGCAACAATATA
ACACGCCATTGTTGTACTCAG	ACACGCCATTATTGTACTCAG
AACCACATATATATTGTAAAC	AACCACATATATATTATAAAC
GGGTGAGCATTGGCACCGCTA	GGGTGAGCATTAGCACCGCTA
AAGTTGCTGATCGATTATCGA	AAGTTGCTGATCGATTATCAA
CTATGGCGACCGCGTTTACCC	CTATGGCGACCGCGTTTCCCC
ATCGGCAGACTTCGTAAGAAA	ATCGGCAGACTGCGTAAGAAA
CATAAAGGAATCTCTCTCAAA	CATAAAGGAATCTCTCTCATA
AAGCGATCAGTTCGCGATCTC	AAGCGATCAGTTCGCGGTCTC
AACATAGTGCTTAGAATTACA	AACATAGTGCTTATAATTACA
ACGGCGGACTCAAACATTTAC	ACGGCGGACTCAAACACTTAC
ACTCTGTGCGTCCATTTAAAA	ACTCTGTGCGTCCATTAAAAA
AGCGTGTACTTTGAGGGTTAT	AGCGTGTACTTTGTGGGTTAT
TAACAAGAGACCGCGAACTGA	TAACAAGAGATCGCGAACTGA
AGGGGCCGGCCATTCGATTCG	AGGGGCCGGCCATTCGAATCG
TCGATGAAAGGGCTTCGCAGA	TCGATGAAAGGACTTCGCAGA
ACCCTGCTCGTGACAATTGGG	ACCCTGCTCGTGACAATTGTG
CTACGCAGCTACTGATACGCA	CTACGCAGCTACTGAAACGCA
GCGCGCGAAAACCTGTCTCAC	GCGCGCGAAAACCGGTCTCAC
AGTGCGGGTACACGTGGTGAG	AGTGCGGGTACACGCGGTGAG
TAACCGGATAAGCATATAAGA	TAACCGGATAAGCACATAAGA
TATCTGTACAAATTTGCCCAA	TATCTGTACAAATTCGCCCAA
CCGCGACGTTTTGATAATCGA	CCGCGACGTTTCGATAATCGA
CCCACGATTTCCGATTCATCC	CCCACGATTTCCGATTCCTCC
CGTGACAATTGGGACGGGGAG	CGTGACAATTGTGACGGGGAG
ACACACGCCATTGTTGTACTC	ACACACGCCATTATTGTACTC
CGACAATTACTTGGACAGAAC	CGACAATTACTTTGACAGAAC
CACCTTGATTTATCCGACTAG	CACCTTGATTTATCCGACTCG
CCTGCGACGAATCGAATGGCC	CCTGCGACGATTCGAATGGCC
CATACTAGCCGGAGAGCCTAC	CATACTAGCCAGAGAGCCTAC
GATTTCCGATTCATCCTTACC	GATTTCCGATTCCTCCTTACC
CCGCGTACTTAGTGCGACAGG	CCGCGTACTTAGTGCGTCAGG
ACCAGGTTGGTGGTTCATGAG	ACCAGGTTGGTGGTTGATGAG
TAGGGTAAGGATGAATCGGAA	TAGGGTAAGGAGGAATCGGAA
CTTCGCATTAGTTTCATCTCA	CTTCGCATTATTTTCATCTCA
TAAAAGGCGATAAATGCATAA	TAAAAGGCGATAAACGCATAA
GCCGGCCATTCGATTCGTCGC	GCCGGCCATTCGAATCGTCGC
TACGGGCGCCCAAACGTGAGA	TACGGGCGCCCAAACGAGAGA
ATATCTGTACAAATTTGCCCA	ATATCTGTACAAATTCGCCCA
CAGACAAGTGTCATTCATCCC	CAGACAAGTGTAATTCATCCC
ATTTATCCGACTAGAGTAGCA	ATTTATCCGACTCGAGTAGCA
CTTAGATAGTTAGACTTATTC	CTTAGATAGTTAGACCTATTC
CAGCTACTGATACGCACCGAC	CAGCTACTGAAACGCACCGAC
CCTCATTCGAAGCACGAGTAA	CCTCATTCGAATCACGAGTAA
CGTTACATTCGGTACGCAGAG	CGTTACATTCGGTACGTAGAG
CATGCGGCTGGTACCGAGGCA	CATGCGGCTGGTACCGAGTCA
GGTTACTCGTGCTTCGAATGA	GGTTACTCGTGATTCGAATGA
AATGCGGAGGACCCTGCTCGA	AATGCGGAGGACCCTGCTCGT
AGTGCATAACCCACAAAGTAC	AGTGCATAACCCTCAAAGTAC
CATCTTGGTCATGGTCCCTAG	CATCTTGGTCATGGTACCTAG
ATCGCCCTAGGAATACACCTC	ATCGCCCTAGGAACACACCTC
AAAAGGCGATAAATGCATAAC	AAAAGGCGATAAACGCATAAC
TAGTCCAGTCCAGCTTTTAAA	TAGTCCAGTCCAGCTTTTTAA
CTAGGGGTAACCACCCTCTCA	CTAGGGGTAACAACCCTCTCA
CGATTTCCGATTCATCCTTAC	CGATTTCCGATTCCTCCTTAC
CCGGCCATTCGATTCGTCGCA	CCGGCCATTCGAATCGTCGCA
CTCCCTGGGTGAGCATTGGCA	CTCCCTGGGTGAGCATTAGCA
GGGCTTACGCGGCCGCGGATA	GGGCTTACGCGGCCGCGGTTA
ACGTTACATTCGGTACGCAGA	ACGTTACATTCGGTACGTAGA
CCGTTGGGACGTATATCTGAA	CCGTTGGGACGTATATGTGAA
CTCTGTGCGTCCATTTAAAAG	CTCTGTGCGTCCATTAAAAAG
CGAATCTATATATCCGCGGCG	CGAATCTATATATACGCGGCG
AGTCCAGTCCAGCTTTTAAAT	AGTCCAGTCCAGCTTTTTAAT
CCTTTTGGTAGGCTCTCCGGC	CCTTTTGGTAGGCTCTCTGGC
CGCCGGATAGGAGCGTCACAC	CGCCGGATAGGAGCGTGACAC
ACTCCCCCAAAAAAGGGTTCG	ACTCCCCCAAAAGAGGGTTCG
AAGTCTTATGCATGGTTTACA	AAGTCTTATGCATGGTTTATA
CCACAGTATAGATCCCCCCCC	CCACAGTATAGATCCCACCCC
CCGGAGCAAGCGCTGATTTTC	CCGGAGCAAGCGCAGATTTTC
AAGGAATCTCTCTCAAATTTA	AAGGAATCTCTCTCATATTTA
GAATATCGGGAGACCCAGTCC	GAATATCGGGAGACCCCGTCC
AGCAGCGCGCGAAAACCTGTC	AGCAGCGCGCGAAAACCGGTC
GGCTGCCAACTCCTTTTGGTA	GGCTGCCAACCCCTTTTGGTA
ATATGGTTTGAATAGATCAGG	ATATGGTTTGAATTGATCAGG
CAAACTGGAAAATTTTATGGA	CAAACTGGAAATTTTTATGGA
AAGAGTCGTCTGCGAAGTCCT	AAGAGTCGTCTGCGAAGCCCT
GTTCTCAAGGGGGCCGCTGCA	GTTCTCAAGGTGGCCGCTGCA
AGGAGTAAAAGGCGATAAACG	AGGAGTAAAAGGCGATAAATG
CCTCCAAGTCAAAAGAACTTC	CCTCCAAGTCAAAGGAACTTC
GATCGATTATCAAAACGTCGC	GATCGATTATCGAAACGTCGC
ATGCGAAGCCCGCACTCATTA	ATGCGAAGCCGGCACTCATTA
CCCACCCTAATACCGTCGCTA	CCCACCCTAATACCGTCGCAA
ATAGGGTCCTCATTCGAAGCA	ATAGGGTCCTCATTCGAATCA
GAACCACATATATATTGTAAA	GAACCACATATATATTATAAA
CGCGCGAAAACCTGTCTCACC	CGCGCGAAAACCGGTCTCACC
GCGCCCAAACGTGAGAGGTGA	GCGCCCAAACGAGAGAGGTGA
AAAGAGTCGTCTGCGAAGTCC	AAAGAGTCGTCTGCGAAGCCC
ATTGGACGGACTGGGTCTCCC	ATTGGACGGACGGGGTCTCCC
ATCACTTGCAGACTAGGGACC	ATCACTTGCAGACTAGGTACC
AAGCAAAGTTAATAGCGACGG	AAGCAAAGTTAATTGCGACGG
TCTTAGTGCATAACCCTCAAA	TCTTAGTGCATAACCCACAAA
CAATATCGGCAGACTTCGTAA	CAATATCGGCAGACTGCGTAA
AGTCGTCTGCGAAGCCCTTTC	AGTCGTCTGCGAAGTCCTTTC
GATCGCCGGATAGGAGCGTCA	GATCGCCGGATAGGAGCGTGA
GCAGTGGTGTGCTTTGGGCGA	GCAGTGGTGTGCTTTGGGCAA
ACATTCGGTACGCAGAGGGAA	ACATTCGGTACGTAGAGGGAA
CTAGTCCAGTCCAGCTTTTAA	CTAGTCCAGTCCAGCTTTTTA
ACACGAGGGATATCCGCGGCC	ACACGAGGGATAACCGCGGCC
AGGTTAGGGGGGGGGATCTAT	AGGTTAGGGGGTGGGATCTAT
TCTCCGGCTGAATAAGTCTAA	TCTCCGGCTGAATAGGTCTAA
ATTTCCGATTCATCCTTACCC	ATTTCCGATTCCTCCTTACCC
CGGGTGGATCGTTTTCTTGAA	CGGGTGGATCGTTATCTTGAA
ACGCCGCGTACTTAGTGCGAC	ACGCCGCGTACTTAGTGCGTC
CAAGCATATGGTTTGAATAGA	CAAGCATATGGTTTGAATTGA
AAGGATCAGGTGATTGAGTAT	AAGGATCAGGTGATTGGGTAT
ACGAGTAACCGTCATGGAGGC	ACGAGTAACCGTCATCGAGGC
CACAGTGGAACGGAGTGCTCC	CACAGTGGAACGGATTGCTCC
AACACTTGCCAGCGATGGCAA	AACACTTGCCAGCCATGGCAA
ATGGCAAGGTAAATGTTTGAG	ATGGCAAGGTAAGTGTTTGAG
ACATATATATTGTAAACCATG	ACATATATATTATAAACCATG
GCGGTGGGTATTCACATATAC	GCGGTGGGTATTCAGATATAC
CTCGTTATCGCCCTAGGAATA	CTCGTTATCGCCCTAGGAACA
ACAAGGATCAGGTGATTGAGT	ACAAGGATCAGGTGATTGGGT
GCAAAGTTAATAGCGACGGTA	GCAAAGTTAATTGCGACGGTA
AGGTTAGCGGTGCCAATGCTC	AGGTTAGCGGTGCTAATGCTC
GGTTTGCTTAAATATGAGAGA	GGTTTGCTTAAATTTGAGAGA
TATCGGCAGACTGCGTAAGAA	TATCGGCAGACTTCGTAAGAA
GTTGAGATGAAACTAATGCGA	GTTGAGATGAAAATAATGCGA
ACATTGATGCTACTAAACGCC	ACATTGATGCTACTAACCGCC
CTTCCCTGTTATGCATTTATC	CTTCCCTGTTATGCGTTTATC
ACGATTTCCGATTCATCCTTA	ACGATTTCCGATTCCTCCTTA
CTGATCGATTATCAAAACGTC	CTGATCGATTATCGAAACGTC
CGCGGGTCTGTTTCTGGGACC	CGCGGGTCTGTTTCTGGTACC
CCTACGCAGCTACTGATACGC	CCTACGCAGCTACTGAAACGC
ACAGGTTAGGGGGGGGGATCT	ACAGGTTAGGGGGTGGGATCT
AAGTTCCCTCTACGTACCGAA	AAGTTCCCTCTGCGTACCGAA
TCGGGAGACTCCCCCAAAAAA	TCGGGAGACTCCCCCAAAAGA
CCCTGGGTGAGCATTGGCACC	CCCTGGGTGAGCATTAGCACC
GACGACACGAGGGATATCCGC	GACGACACGAGGGATAACCGC
ACTTGCAGACTAGGGACCATG	ACTTGCAGACTAGGTACCATG
TCATGTAACAAGAGATCGCGA	TCATGTAACAAGAGACCGCGA
GGTGGATCGTTTTCTTGAACA	GGTGGATCGTTATCTTGAACA
CATGACGGTTACTCGTGCTTC	CATGACGGTTACTCGTGATTC
CTACACACGCCATTGTTGTAC	CTACACACGCCATTATTGTAC
CTCTCCCTAATGAGTGCGGGC	CTCTCCCTAATGAGTGCCGGC
CTAATGAGTGCGGGCTTCGCA	CTAATGAGTGCCGGCTTCGCA
ACTAAAGTTCTGTCAAAGTAA	ACTAAAGTTCTGTCCAAGTAA
CAGTGTACTGGATCCTCACCC	CAGTGTACTGGATCATCACCC
TGGTATATTGTTGGCTATACA	TGGTATATTGTTGCCTATACA
ACTGTGGGCTTGCGAGATTAG	ACTGTGGGCTTGCGAGGTTAG
ACGCAGCTACTGATACGCACC	ACGCAGCTACTGAAACGCACC
TATACGACAATTACTTGGACA	TATACGACAATTACTTTGACA
CTCAACTAGGGGTAACCACCC	CTCAACTAGGGGTAACAACCC
GCATACTAGCCGGAGAGCCTA	GCATACTAGCCAGAGAGCCTA
AAAGGCGATAAATGCATAACA	AAAGGCGATAAACGCATAACA
ATGCGGCTGGTACCGAGGCAC	ATGCGGCTGGTACCGAGTCAC
CACTTGCCAGCGATGGCAAGG	CACTTGCCAGCCATGGCAAGG
GGATTTCTGTAGCTTATAATA	GGATTTCTGTAGCTGATAATA
ACTACTTAGGGTAAGGAGGAA	ACTACTTAGGGTAAGGATGAA
CCCTCCCAGTAGTTCTGCTAC	CCCTCCCAGTAGTTTTGCTAC
AATTACAGGTTAGGGGGGGGG	AATTACAGGTTAGGGGGTGGG
ATCGCGAACCCTCTTTTGGGG	ATCGCGAACCCTTTTTTGGGG
CTCGCGTCCTTATATTATCAG	CTCGCGTCCTAATATTATCAG
AGTCAGTCGTCGGTCCCAGAA	AGTCAGTCGTCGGTACCAGAA
AACCCTGATCTATTCAAACCA	AACCCTGATCAATTCAAACCA
CTGTCCACACGATACTGTATA	CTGTCCACACGAGACTGTATA
AATCACTTGCAGACTAGGGAC	AATCACTTGCAGACTAGGTAC
ACGAGGGATATCCGCGGCCGC	ACGAGGGATAACCGCGGCCGC
GTCTGTTTCTGGGACCGACGA	GTCTGTTTCTGGTACCGACGA
CGGGTCTGTTTCTGGGACCGA	CGGGTCTGTTTCTGGTACCGA
AATATCGGGAGACCCAGTCCG	AATATCGGGAGACCCCGTCCG
AAAGAAGTTCTTTTGACTTGG	AAAGAAGTTCCTTTGACTTGG
GAAATGTATGGCTGCCAACCC	GAAATGTATGGCTGCCAACTC
ATAACTAAAGTTCTGTCCAAG	ATAACTAAAGTTCTGTCAAAG
CGACGACTGACTTGTATTCTA	CGACGACTGACTCGTATTCTA
GATAGGAGCGTCACACTGGAA	GATAGGAGCGTGACACTGGAA
GCTGATAATATAAGGACGCGA	GCTGATAATATTAGGACGCGA
AAACCCTGATCTATTCAAACC	AAACCCTGATCAATTCAAACC
GAATCTTAGTGCATAACCCTC	GAATCTTAGTGCATAACCCAC
AATGTTCAAGAAAACGATCCA	AATGTTCAAGATAACGATCCA
CAGTGGAACGGATTGCTCCCC	CAGTGGAACGGAGTGCTCCCC
CAATCCCAAACTAGTGGGTCC	CAATCCCAAAGTAGTGGGTCC
CATGTAACAAGAGATCGCGAA	CATGTAACAAGAGACCGCGAA
ACTACACACGCCATTATTGTA	ACTACACACGCCATTGTTGTA
AGAGCCTACCAAAAGGAGTTG	AGAGCCTACCAAAAGGGGTTG
GCAGCTCGCGTCCTAATATTA	GCAGCTCGCGTCCTTATATTA
CATAGTGCTTAGAATTACAGG	CATAGTGCTTATAATTACAGG
ATTACTGCTAACTCGTGACAG	ATTACTGCTATCTCGTGACAG
CGGCTTCGCATTAGTTTCATC	CGGCTTCGCATTATTTTCATC
GTTGCTGATCGATTATCAAAA	GTTGCTGATCGATTATCGAAA
GGATAGGAGCGTCACACTGGA	GGATAGGAGCGTGACACTGGA
ACGGGCGCCCAAACGTGAGAG	ACGGGCGCCCAAACGAGAGAG
GAGGAACCGCCAACCTAACTA	GAGGAACCGCCACCCTAACTA
TACTCTGTGCGTCCATTTAAA	TACTCTGTGCGTCCATTAAAA
GAGCAAGCGCTGATTTTCTGA	GAGCAAGCGCAGATTTTCTGA
CCCAGTAGTTCTGCTACCGTA	CCCAGTAGTTTTGCTACCGTA
ACAACACTTGCCAGCGATGGC	ACAACACTTGCCAGCCATGGC
GACGGCGGACTCAAACATTTA	GACGGCGGACTCAAACACTTA
CCGTCGGTGCGTATCAGTAGC	CCGTCGGTGCGTTTCAGTAGC
GATCCTCCAAGTCAAAAGAAC	GATCCTCCAAGTCAAAGGAAC
AGATAGTTAGACTTATTCAGC	AGATAGTTAGACCTATTCAGC
CATAACAGGGAAGTTTCGAGG	CATAACAGGGAAGATTCGAGG
AGCCGCATGGTTCAACTCACA	AGCCGCATGGTTCAACACACA
CACCAGGTTGGTGGTTCATGA	CACCAGGTTGGTGGTTGATGA
AATATCGGCAGACTTCGTAAG	AATATCGGCAGACTGCGTAAG
ACTGAAAGCAAAGTTAATAGC	ACTGAAAGCAAAGTTAATTGC
CACTCTCCCTAATGAGTGCGG	CACTCTCCCTAATGAGTGCCG
CGCTTGGTATATTGTTGGCTA	CGCTTGGTATATTGTTGCCTA
ACTTAGGGTAAGGAGGAATCG	ACTTAGGGTAAGGATGAATCG
CAAAGAAGTTCTTTTGACTTG	CAAAGAAGTTCCTTTGACTTG
GCAGACTAGGGACCATGACCA	GCAGACTAGGTACCATGACCA
CACCTGTCTAGAATACAAGTC	CACCTGTCTAGAATACGAGTC
CTCCCGATATTCCAGTGTGAC	CTCCCGATATTCCAGTGTCAC
CGAGTACTCTGTCACGAGATA	CGAGTACTCTGTCACGAGTTA
ATGCATGGTTTACAATATATA	ATGCATGGTTTATAATATATA
GACACGAGGGATATCCGCGGC	GACACGAGGGATAACCGCGGC
GACTATACGGTAGCAAAACTA	GACTATACGGTAGCAGAACTA
CCTACCAAAAGGAGTTGGCAG	CCTACCAAAAGGGGTTGGCAG
GAGAAGTTCCCTCTACGTACC	GAGAAGTTCCCTCTGCGTACC
GTCAGTCGTCGGTCCCAGAAA	GTCAGTCGTCGGTACCAGAAA
CATCTCCATAAAAATTTCCAG	CATCTCCATAAAATTTTCCAG
GATTTATCCGACTAGAGTAGC	GATTTATCCGACTCGAGTAGC
ACCAGCCGCATGGTTCAACTC	ACCAGCCGCATGGTTCAACAC
GGAGGGGGGGGGGAGCACTCC	GGAGGGGGGGGGGAGCAATCC
ACTAGGGGTAACCACCCTCTC	ACTAGGGGTAACAACCCTCTC
CGCAGCTACTGATACGCACCG	CGCAGCTACTGAAACGCACCG
AACAGGGAAGTTTCGAGGTGT	AACAGGGAAGATTCGAGGTGT
AATCTTAGTGCATAACCCACA	AATCTTAGTGCATAACCCTCA
GGGGGGGAGCAATCCGTTCCA	GGGGGGGAGCACTCCGTTCCA
GAGAAACACCCTGTCGCACTA	GAGAAACACCCTGACGCACTA
CCCCTACGCAGCTACTGATAC	CCCCTACGCAGCTACTGAAAC
AGGCGATAAATGCATAACAGG	AGGCGATAAACGCATAACAGG
GCCGTTGGGACGTATATCTGA	GCCGTTGGGACGTATATGTGA
TCGGGAGACCCAGTCCGTCCA	TCGGGAGACCCCGTCCGTCCA
GCGCTGCAGCGGCCACCTTGA	GCGCTGCAGCGGCCCCCTTGA
GGTGCAACTCGTCGCATACTA	GGTGCAACTCATCGCATACTA
CGTGTTGACATGTATAGCCAA	CGTGTTGACATGTATAGGCAA
ATGCGGAGGACCCTGCTCGAG	ATGCGGAGGACCCTGCTCGTG
CATGCATAAGACTTCAGGGCC	CATGCATAAGACTTCAGGGGC
AGCGCGCGAAAACCTGTCTCA	AGCGCGCGAAAACCGGTCTCA
ACGACACGAGGGATATCCGCG	ACGACACGAGGGATAACCGCG
CCCTAATACCGTCGCTATTAA	CCCTAATACCGTCGCAATTAA
GGACGTATATCTGAATACCCA	GGACGTATATGTGAATACCCA
AGGATCAGGTGATTGAGTATC	AGGATCAGGTGATTGGGTATC
CTTACGCGGCCGCGGATATCC	CTTACGCGGCCGCGGTTATCC
CTGTGGGCTTGCGAGATTAGC	CTGTGGGCTTGCGAGGTTAGC
CAGCCGCATGGTTCAACTCAC	CAGCCGCATGGTTCAACACAC
GATATTCCAGTGTGACGCTCC	GATATTCCAGTGTCACGCTCC
ACCTGAAGTTAAATGAGGTTC	ACCTGAAGTTAAATGACGTTC
ATACCGTCGCTATTAACTTTG	ATACCGTCGCAATTAACTTTG
ATCAGGTGATTGAGTATCGTA	ATCAGGTGATTGGGTATCGTA
GCTGCAGCGGCCACCTTGAGA	GCTGCAGCGGCCCCCTTGAGA
CCTCAACTAGGGGTAACCACC	CCTCAACTAGGGGTAACAACC
CTACCAAAAGGAGTTGGCAGC	CTACCAAAAGGGGTTGGCAGC
AGACAAGTGTCATTCATCCCA	AGACAAGTGTAATTCATCCCA
CAGCGTGCTCTTATATGCTTA	CAGCGTGCTCTTATGTGCTTA
CTCTTTCGATGAAAGGACTTC	CTCTTTCGATGAAAGGGCTTC
TCAGGACCCACTACTTTGGGA	TCAGGACCCACTAGTTTGGGA
AGTACTCTGTCACGAGATAGC	AGTACTCTGTCACGAGTTAGC
ACGGTTACTCGTGCTTCGAAT	ACGGTTACTCGTGATTCGAAT
GCAGAGAAACACCCTGACGCA	GCAGAGAAACACCCTGTCGCA
CCCCCTAACCTGTAATTCTAA	CCCCCTAACCTGTAATTATAA
ATCTCTCTCAAATTTAAGCAA	ATCTCTCTCATATTTAAGCAA
CACACTGAGTACAACAATGGC	CACACTGAGTACAATAATGGC
CCCTGTTATGCATTTATCGCC	CCCTGTTATGCGTTTATCGCC
GGAGGACCCTGCTCGAGACAA	GGAGGACCCTGCTCGTGACAA
ATTCTTGCTACTCTAGTCGGA	ATTCTTGCTACTCGAGTCGGA
CGGTGGGTATTCACATATACG	CGGTGGGTATTCAGATATACG
CACTGCAAGGACTCCACGGTC	CACTGCAAGGACTCCACGGCC
CTGGTACCGAGGCACAATGGA	CTGGTACCGAGTCACAATGGA
ATCTTAGTGCATAACCCTCAA	ATCTTAGTGCATAACCCACAA
TCGCCGGATAGGAGCGTCACA	TCGCCGGATAGGAGCGTGACA
GATACGAATCTATATATCCGC	GATACGAATCTATATATACGC
ATAACCGGATAAGCACATAAG	ATAACCGGATAAGCATATAAG
AACTACACACGCCATTGTTGT	AACTACACACGCCATTATTGT
CGGATAAGCACATAAGAGCAC	CGGATAAGCATATAAGAGCAC
CCAGCCGCATGGTTCAACACA	CCAGCCGCATGGTTCAACTCA
AGTACGGGCGCCCAAACGTGA	AGTACGGGCGCCCAAACGAGA
GGAATAACATAGTGCTTAGAA	GGAATAACATAGTGCTTATAA
ATGTAACAAGAGATCGCGAAC	ATGTAACAAGAGACCGCGAAC
AGAGAAACACCCTGTCGCACT	AGAGAAACACCCTGACGCACT
CAGCGCGCGAAAACCTGTCTC	CAGCGCGCGAAAACCGGTCTC
CAAACCCTGATCTATTCAAAC	CAAACCCTGATCAATTCAAAC
AGATAGGGTCCTCATTCGAAG	AGATAGGGTCCTCATTCGAAT
CTCTTAGCGGTGCAACTCATC	CTCTTAGCGGTGCAACTCGTC
CATATGGTTTGAATAGATCAG	CATATGGTTTGAATTGATCAG
CCACTCTCCCTAATGAGTGCG	CCACTCTCCCTAATGAGTGCC
CACGAGGGATATCCGCGGCCG	CACGAGGGATAACCGCGGCCG
ATAAAGGAATCTCTCTCAAAT	ATAAAGGAATCTCTCTCATAT
AGATCGCCGGATAGGAGCGTG	AGATCGCCGGATAGGAGCGTC
ACACTTGCCAGCGATGGCAAG	ACACTTGCCAGCCATGGCAAG
CCCTGCGACGAATCGAATGGC	CCCTGCGACGATTCGAATGGC
ATGACAATATCGGCAGACTTC	ATGACAATATCGGCAGACTGC
ATCATATAACCGGATAAGCAC	ATCATATAACCGGATAAGCAT
AGCGGGGTTTGCTTAAATATG	AGCGGGGTTTGCTTAAATTTG
CCATGCGGCTGGTACCGAGGC	CCATGCGGCTGGTACCGAGTC
ATGACGGTTACTCGTGCTTCG	ATGACGGTTACTCGTGATTCG
AATATGTCAGACAAGTGTCAT	AATATGTCAGACAAGTGTAAT
ATTGCACACTGAGTACAATAA	ATTGCACACTGAGTACAACAA
AGGAATCTCTCTCATATTTAA	AGGAATCTCTCTCAAATTTAA
CGGCTGGTCAATCCCAAACTA	CGGCTGGTCAATCCCAAAGTA
AACCGGATAAGCATATAAGAG	AACCGGATAAGCACATAAGAG
GTGCGGTTATTTTCTTACGCA	GTGCGGTTATTTTCTTACGAA
CGGCCATTCGATTCGTCGCAG	CGGCCATTCGAATCGTCGCAG
ATTGTCGTATACAGTCTCGTG	ATTGTCGTATACAGTATCGTG
CAGAACATTGATGCTACTAAA	CAGAACATTGATGCTACTAAC
AGTGACTATACGGTAGCAAAA	AGTGACTATACGGTAGCAGAA
ACCGGAGCGTGTACTTTGAGG	ACCGGAGCGTGTACTTTGTGG
GAGCGTGTACTTTGAGGGTTA	GAGCGTGTACTTTGTGGGTTA
ACGTGATGTCTCCATTGTGAC	ACGTGATGTCTCCATTGTGCC
AAGTTCTGTCAAAGTAATTGT	AAGTTCTGTCCAAGTAATTGT
TATTACTGCTAACTCGTGACA	TATTACTGCTATCTCGTGACA
AGTCTTATGCATGGTTTACAA	AGTCTTATGCATGGTTTATAA
CGGAACCTGAAGTTAAATGAG	CGGAACCTGAAGTTAAATGAC
TCGGCAGACTGCGTAAGAAAA	TCGGCAGACTTCGTAAGAAAA
AGAAGTTCCCTCTACGTACCG	AGAAGTTCCCTCTGCGTACCG
CCTAGTTGAGGAACCGCCACC	CCTAGTTGAGGAACCGCCAAC
ATGTCAGACAAGTGTAATTCA	ATGTCAGACAAGTGTCATTCA
CGCGCGGGTCTGTTTCTGGGA	CGCGCGGGTCTGTTTCTGGTA
TCATAACTAAAGTTCTGTCCA	TCATAACTAAAGTTCTGTCAA
GCTTCAGTTGAGATGAAACTA	GCTTCAGTTGAGATGAAAATA
AGTTGAGGAACCGCCAACCTA	AGTTGAGGAACCGCCACCCTA
AGATACGAATCTATATATCCG	AGATACGAATCTATATATACG
GCGGCTGGTACCGAGTCACAA	GCGGCTGGTACCGAGGCACAA
TGCGGCTGGTACCGAGTCACA	TGCGGCTGGTACCGAGGCACA
ACGGAATAACATAGTGCTTAG	ACGGAATAACATAGTGCTTAT
GGGTCCTCATTCGAAGCACGA	GGGTCCTCATTCGAATCACGA
ACAATATCGGCAGACTGCGTA	ACAATATCGGCAGACTTCGTA
ACTGCAAGGACTCCACGGTCT	ACTGCAAGGACTCCACGGCCT
TTACCTTGCCATGGCTGGCAA	TTACCTTGCCATCGCTGGCAA
CTCATTCGAAGCACGAGTAAC	CTCATTCGAATCACGAGTAAC
AGATCCTCCAAGTCAAAAGAA	AGATCCTCCAAGTCAAAGGAA
CCCCCCTCCCAGTAGTTCTGC	CCCCCCTCCCAGTAGTTTTGC
CAATATGTCAGACAAGTGTCA	CAATATGTCAGACAAGTGTAA
AGCTCGCGTCCTAATATTATC	AGCTCGCGTCCTTATATTATC
CTGAAGTTAAATGACGTTCTC	CTGAAGTTAAATGAGGTTCTC
AGAAACACCCTGTCGCACTAA	AGAAACACCCTGACGCACTAA
CCTCCCACGATTTCCGATTCC	CCTCCCACGATTTCCGATTCA
GGCAAACCCTGATCTATTCAA	GGCAAACCCTGATCAATTCAA
CGTGCGGTTATTTTCTTACGC	CGTGCGGTTATTTTCTTACGA
CAAGTGACTATACGGTAGCAA	CAAGTGACTATACGGTAGCAG
CTCGGGAGACTCCCCCAAAAA	CTCGGGAGACTCCCCCAAAAG
ACTCCCCGTCCCAATTGTCAC	ACTCCCCGTCACAATTGTCAC
GAGATACGAATCTATATATCC	GAGATACGAATCTATATATAC
TCCTTTTCAATTCGACCTGCA	TCCTTTTCAATTCGACCTGAA
CACGTGATGTCTCCATTGTGA	CACGTGATGTCTCCATTGTGC
CGGGAGACCCAGTCCGTCCAA	CGGGAGACCCCGTCCGTCCAA
AGTCTTCAGCGTGCTCTTATA	AGTCTTCAGCGTGCTCTTATG
ACTATGGCGACCGCGTTTACC	ACTATGGCGACCGCGTTTCCC
CTTCAGCGTGCTCTTATATGC	CTTCAGCGTGCTCTTATGTGC
GAGATCCTCCAAGTCAAAAGA	GAGATCCTCCAAGTCAAAGGA
CTTTGGGAATGTTCAAGAAAA	CTTTGGGAATGTTCAAGATAA
CAGTGGTGTGCTTTGGGCAAA	CAGTGGTGTGCTTTGGGCGAA
AGGGTCCTCATTCGAAGCACG	AGGGTCCTCATTCGAATCACG
AGTCCAGCTTTTAAATGGACG	AGTCCAGCTTTTTAATGGACG
ACATCTTGGTCATGGTCCCTA	ACATCTTGGTCATGGTACCTA
AGTGGTGTGCTTTGGGCGAAT	AGTGGTGTGCTTTGGGCAAAT
GGAACCGCCACCCTAACTACA	GGAACCGCCAACCTAACTACA
AGAACCACATATATATTGTAA	AGAACCACATATATATTATAA
AAGAACCACATATATATTGTA	AAGAACCACATATATATTATA
ACACTGAGTACAACAATGGCG	ACACTGAGTACAATAATGGCG
GTGCGGGTACACGCGGTGAGA	GTGCGGGTACACGTGGTGAGA
ACTCTCCCTAATGAGTGCGGG	ACTCTCCCTAATGAGTGCCGG
GATGGTTGAGAGGGTGGTTAC	GATGGTTGAGAGGGTTGTTAC
CTCCGGCTGAATAAGTCTAAC	CTCCGGCTGAATAGGTCTAAC
CTTTCAGTGTACTGGATCCTC	CTTTCAGTGTACTGGATCATC
AGCGGTGCAACTCATCGCATA	AGCGGTGCAACTCGTCGCATA
TAGGGGTAACCACCCTCTCAA	TAGGGGTAACAACCCTCTCAA
GGGACGTATATCTGAATACCC	GGGACGTATATGTGAATACCC
CGTGTACTTTGAGGGTTATGC	CGTGTACTTTGTGGGTTATGC
CGGTCGTGTCAGAAAATCTGC	CGGTCGTGTCAGAAAATCAGC
AAGGGGCCGGCCATTCGATTC	AAGGGGCCGGCCATTCGAATC
CATATGAAAAGGGTGAGGATC	CATATGAAAAGGGTGATGATC
AAGTTAAATGACGTTCTCAAG	AAGTTAAATGAGGTTCTCAAG
GGTTCTTTACTCCCCGTCCCA	GGTTCTTTACTCCCCGTCACA
AGCCGCGACGTTTTGATAATC	AGCCGCGACGTTTCGATAATC
GTGCATAACCCTCAAAGTACA	GTGCATAACCCACAAAGTACA
ACTTGGCAAACCCTGATCAAT	ACTTGGCAAACCCTGATCTAT
ATACGAATCTATATATCCGCG	ATACGAATCTATATATACGCG
CCATCTCCATAAAATTTTCCA	CCATCTCCATAAAAATTTCCA
ATAACATAGTGCTTAGAATTA	ATAACATAGTGCTTATAATTA
AGCGTGCTCTTATGTGCTTAT	AGCGTGCTCTTATATGCTTAT
ATTACAGGTTAGGGGGGGGGA	ATTACAGGTTAGGGGGTGGGA
TCTGTCACGAGTTAGCAGTAA	TCTGTCACGAGATAGCAGTAA
CCCTGCTCGTGACAATTGTGA	CCCTGCTCGTGACAATTGGGA
GCAGCTACTGATACGCACCGA	GCAGCTACTGAAACGCACCGA
CTGGATTTCTGTAGCTTATAA	CTGGATTTCTGTAGCTGATAA
CGTATACAGTCTCGTGTGGAC	CGTATACAGTATCGTGTGGAC
TCACTTGCAGACTAGGGACCA	TCACTTGCAGACTAGGTACCA
GCTCGCGTCCTTATATTATCA	GCTCGCGTCCTAATATTATCA
AATCTCTCTCATATTTAAGCA	AATCTCTCTCAAATTTAAGCA
CCATGCATAAGACTTCAGGGC	CCATGCATAAGACTTCAGGGG
CTGGGTGAGCATTGGCACCGC	CTGGGTGAGCATTAGCACCGC
AATTGTCGTATACAGTATCGT	AATTGTCGTATACAGTCTCGT
ATATGAAAAGGGTGAGGATCC	ATATGAAAAGGGTGATGATCC
CCCCTAACCTGTAATTCTAAG	CCCCTAACCTGTAATTATAAG
AATAACATAGTGCTTAGAATT	AATAACATAGTGCTTATAATT
ATGGCGTGTGTAGTTAGGGTG	ATGGCGTGTGTAGTTAGGTTG
AGTTGCTGATCGATTATCAAA	AGTTGCTGATCGATTATCGAA
AAAAGGGTGAGGATCCAGTAC	AAAAGGGTGATGATCCAGTAC
CAACACTTGCCAGCGATGGCA	CAACACTTGCCAGCCATGGCA
ATTCATGTAACAAGAGATCGC	ATTCATGTAACAAGAGACCGC
ACGCGGCCGCGGATATCCCTC	ACGCGGCCGCGGTTATCCCTC
CGTAGCGGGTGGATCGTTTTC	CGTAGCGGGTGGATCGTTATC
AGTTCGGTCTCACCTCTCACG	AGTTCGGTCTCACCTCTCTCG
GTTGACATGTATAGCCAACAA	GTTGACATGTATAGGCAACAA
CTCCATTGTGCCTCGGTACCA	CTCCATTGTGACTCGGTACCA
GTGACTATACGGTAGCAAAAC	GTGACTATACGGTAGCAGAAC
ATCGCCGGATAGGAGCGTGAC	ATCGCCGGATAGGAGCGTCAC
ACGTGTTGACATGTATAGCCA	ACGTGTTGACATGTATAGGCA
ATCCGTCGGTGCGTATCAGTA	ATCCGTCGGTGCGTTTCAGTA
GAGTAAAAGGCGATAAACGCA	GAGTAAAAGGCGATAAATGCA
ATATAACCGGATAAGCACATA	ATATAACCGGATAAGCATATA
GGTTAGGGGGGGGGATCTATA	GGTTAGGGGGTGGGATCTATA
GGGGGGAGCAATCCGTTCCAC	GGGGGGAGCACTCCGTTCCAC
ACAATTGTGACGGGGAGTAAA	ACAATTGGGACGGGGAGTAAA
CTGCTATCTCGTGACAGAGTA	CTGCTAACTCGTGACAGAGTA
CATCGCTGGCAAGTGTTGTCG	CATGGCTGGCAAGTGTTGTCG
GGGTAACCACCCTCTCAACCA	GGGTAACAACCCTCTCAACCA
GAGACTGTATACGACAATTAC	GATACTGTATACGACAATTAC
ATACGCACCGACGGATGTAAT	AAACGCACCGACGGATGTAAT
CTCTCTCAAATTTAAGCAAAC	CTCTCTCATATTTAAGCAAAC
ATGGTCCCTAGTCTGCAAGTG	ATGGTACCTAGTCTGCAAGTG
AAGGATGAATCGGAAATCGTG	AAGGAGGAATCGGAAATCGTG
AAGAAAACGATCCACCCGCTA	AAGATAACGATCCACCCGCTA
ATATTGTTGGCTATACATGTC	ATATTGTTGCCTATACATGTC
GTATTCAGATATACGTCCCAA	GTATTCACATATACGTCCCAA
AAAAGGAGTTGGCAGCCATAC	AAAAGGGGTTGGCAGCCATAC
AGCGGTGCCAATGCTCACCCA	AGCGGTGCTAATGCTCACCCA
AGTTGGCAGCCATACATTTCA	GGTTGGCAGCCATACATTTCA
ATGTATAGCCAACAATATACC	ATGTATAGGCAACAATATACC
CCCTAGTCTGCAAGTGATTGC	ACCTAGTCTGCAAGTGATTGC
CAAGTGTCATTCATCCCACTA	CAAGTGTAATTCATCCCACTA
CTGTGAGTTGAACCATGCGGC	CTGTGTGTTGAACCATGCGGC
GAACGGATTGCTCCCCCCCCC	GAACGGAGTGCTCCCCCCCCC
GAGTTAGCAGTAATAAACTCA	GAGATAGCAGTAATAAACTCA
ACCGCCACCCTAACTACACAC	ACCGCCAACCTAACTACACAC
GTGCTTCGAATGAGGACCCTA	GTGATTCGAATGAGGACCCTA
AACAAGAGATCGCGAACTGAT	AACAAGAGACCGCGAACTGAT
AGACTTCGTAAGAAAATAACC	AGACTGCGTAAGAAAATAACC
AACCGCCACCCTAACTACACA	AACCGCCAACCTAACTACACA
AGCCGGAGAGCCTACCAAAAG	AGCCAGAGAGCCTACCAAAAG
CTTATATTATCAGCTACAGAA	CTAATATTATCAGCTACAGAA
TCAAAGTACACGCTCCGGTAA	ACAAAGTACACGCTCCGGTAA
AGTATCGTGTGGACAGGGGCA	AGTCTCGTGTGGACAGGGGCA
TATATTGTAAACCATGCATAA	TATATTATAAACCATGCATAA
CAGGTTTTCGCGCGCTGCTAC	CCGGTTTTCGCGCGCTGCTAC
ATATATTGTAAACCATGCATA	ATATATTATAAACCATGCATA
AATAGCGACGGTATTAGGGTG	AATTGCGACGGTATTAGGGTG
CTCTCATATTTAAGCAAACCC	CTCTCAAATTTAAGCAAACCC
CGAGGGATATCCGCGGCCGCG	CGAGGGATAACCGCGGCCGCG
CCCTCTGCGTACCGAATGTAA	CCCTCTACGTACCGAATGTAA
AGACAGGTTTTCGCGCGCTGC	AGACCGGTTTTCGCGCGCTGC
CCCCCAAAAAAGGGTTCGCGA	CCCCCAAAAGAGGGTTCGCGA
CGAAGTCTGCCGATATTGTCA	CGCAGTCTGCCGATATTGTCA
AGTCACAATGGAGACATCACG	AGGCACAATGGAGACATCACG
CGCCACCCTAACTACACACGC	CGCCAACCTAACTACACACGC
CACAGTCTCTTTCGATGAAAG	CACAGACTCTTTCGATGAAAG
AATGACACTTGTCTGACATAT	AATTACACTTGTCTGACATAT
TAATCTCGCAAGCCCACAGTA	TAACCTCGCAAGCCCACAGTA
ACTTTGACAGAACTTTAGTTA	ACTTGGACAGAACTTTAGTTA
AAGAGACCGCGAACTGATCGC	AAGAGATCGCGAACTGATCGC
ACTTGTATTCTAGACAGGTGA	ACTCGTATTCTAGACAGGTGA
ACCTCGAAACTTCCCTGTTAT	ACCTCGAATCTTCCCTGTTAT
CGGATTGCTCCCCCCCCCCTC	CGGAGTGCTCCCCCCCCCCTC
GATAAGCATATAAGAGCACGC	GATAAGCACATAAGAGCACGC
AAAGAGGGTTCGCGATCAAAC	AAAAAGGGTTCGCGATCAAAC
GTTGTTACCCCTAGTTGAGGA	GTGGTTACCCCTAGTTGAGGA
ATAGGCAACAATATACCAAGC	ATAGCCAACAATATACCAAGC
CACAAAGTACACGCTCCGGTA	CTCAAAGTACACGCTCCGGTA
AGGTGTATTCCTAGGGCGATA	AGGTGTGTTCCTAGGGCGATA
CGTCACAATTGTCACGAGCAG	CGTCCCAATTGTCACGAGCAG
GTCAAAAGAACTTCTTTGCAC	GTCAAAGGAACTTCTTTGCAC
CGCGGCGTTTAGTAGCATCAA	CGCGGCGGTTAGTAGCATCAA
ATGAGACCGTGGAGTCCTTGC	ATGAGGCCGTGGAGTCCTTGC
TATCAAAACGTCGCGGCTAGA	TATCGAAACGTCGCGGCTAGA
CGATAAATGCATAACAGGGAA	CGATAAACGCATAACAGGGAA
GAGATGAAACTAATGCGAAGC	GAGATGAAAATAATGCGAAGC
AATTTCCAGTTTGCGGTCGCC	ATTTTCCAGTTTGCGGTCGCC
GAGTGCTCCCCCCCCCCTCCC	GATTGCTCCCCCCCCCCTCCC
AACGTGAGAGGTGAGACCGAA	AACGAGAGAGGTGAGACCGAA
CGACGAATCGAATGGCCGGCC	CGACGATTCGAATGGCCGGCC
CGTTTTGATAATCGATCAGCA	CGTTTCGATAATCGATCAGCA
CCGATTCCTCCTTACCCTAAG	CCGATTCATCCTTACCCTAAG
GATCGTTTTCTTGAACATTCC	GATCGTTATCTTGAACATTCC
CTGTCGCACTAAGTACGCGGC	CTGACGCACTAAGTACGCGGC
CGGTTATCCCTCGTGTCGTCC	CGGATATCCCTCGTGTCGTCC
TAGTCGGATAAATCAAGGTGA	GAGTCGGATAAATCAAGGTGA
AACTCCTTTTGGTAGGCTCTC	AACCCCTTTTGGTAGGCTCTC
GTATTCCTAGGGCGATAACGA	GTGTTCCTAGGGCGATAACGA
CGCTATTAACTTTGCTTTCAG	CGCAATTAACTTTGCTTTCAG
AGGCAACAATATACCAAGCGC	AGCCAACAATATACCAAGCGC
ACTTCGTAAGAAAATAACCGC	ACTGCGTAAGAAAATAACCGC
CGCAGGGTAAACGCGGTCGCC	CGCAGGGGAAACGCGGTCGCC
ACACGAGACTGTATACGACAA	ACACGATACTGTATACGACAA
CCGAGTCACAATGGAGACATC	CCGAGGCACAATGGAGACATC
CGCTAATCTCGCAAGCCCACA	CGCTAACCTCGCAAGCCCACA
GGGGTAACCACCCTCTCAACC	GGGGTAACAACCCTCTCAACC
AGTGCTTAGAATTACAGGTTA	AGTGCTTATAATTACAGGTTA
TACTCTAGTCGGATAAATCAA	TACTCGAGTCGGATAAATCAA
CAGTTCGCGGTCTCTTGTTAC	CAGTTCGCGATCTCTTGTTAC
GACAATTGGGACGGGGAGTAA	GACAATTGTGACGGGGAGTAA
GCGTGTACCCGCACTATGGCC	ACGTGTACCCGCACTATGGCC
AAGTTAATAGCGACGGTATTA	AAGTTAATTGCGACGGTATTA
ACTTTGGGATTGACCAGCCGC	AGTTTGGGATTGACCAGCCGC
CCAAACGTGAGAGGTGAGACC	CCAAACGAGAGAGGTGAGACC
ACTTTGAGGGTTATGCACTAA	ACTTTGTGGGTTATGCACTAA
ATCGTTTTCTTGAACATTCCC	ATCGTTATCTTGAACATTCCC
AAAGTTAATAGCGACGGTATT	AAAGTTAATTGCGACGGTATT
CCATTTAAAAGCTGGACTGGA	CCATTAAAAAGCTGGACTGGA
GAAGCCCGCACTCATTAGGGA	GAAGCCGGCACTCATTAGGGA
GAATTGATCAGGGTTTGCCAA	GAATAGATCAGGGTTTGCCAA
CAACCACCAACCTGGTGGGTC	GAACCACCAACCTGGTGGGTC
TAACCACCCTCTCAACCATCA	TAACAACCCTCTCAACCATCA
ATATAAGGACGCGAGCTGCGA	ATATTAGGACGCGAGCTGCGA
CCGCTAATCTCGCAAGCCCAC	CCGCTAACCTCGCAAGCCCAC
TACGCACCGACGGATGTAATA	AACGCACCGACGGATGTAATA
CTTCGTAAGAAAATAACCGCA	CTGCGTAAGAAAATAACCGCA
CAATTGGGACGGGGAGTAAAG	CAATTGTGACGGGGAGTAAAG
AATTGTGACGGGGAGTAAAGA	AATTGGGACGGGGAGTAAAGA
ACGGACTGGGTCTCCCGATAT	ACGGACGGGGTCTCCCGATAT
ACCCTGTCGCACTAAGTACGC	ACCCTGACGCACTAAGTACGC
GTGCGTATCAGTAGCTGCGTA	GTGCGTTTCAGTAGCTGCGTA
ACCGCTAATCTCGCAAGCCCA	ACCGCTAACCTCGCAAGCCCA
AATAGATCAGGGTTTGCCAAG	AATTGATCAGGGTTTGCCAAG
AGCAAAACTACTGGGAGGGGG	AGCAGAACTACTGGGAGGGGG
AAGCGCTGATTTTCTGACACG	AAGCGCAGATTTTCTGACACG
GTGAGGATCCAGTACACTGAA	GTGATGATCCAGTACACTGAA
CGCTGATTTTCTGACACGACC	CGCAGATTTTCTGACACGACC
ACTCGAGTAGCAAGAATCCCC	ACTAGAGTAGCAAGAATCCCC
AATCCCAAACTAGTGGGTCCT	AATCCCAAAGTAGTGGGTCCT
GTTTTGATAATCGATCAGCAA	GTTTCGATAATCGATCAGCAA
GGTGATTGAGTATCGTATTAC	GGTGATTGGGTATCGTATTAC
AAGCCCGCACTCATTAGGGAG	AAGCCGGCACTCATTAGGGAG
ATTCAGATATACGTCCCAACG	ATTCACATATACGTCCCAACG
TCGAAGCACGAGTAACCGTCA	TCGAATCACGAGTAACCGTCA
AAAATTTCCAGTTTGCGGTCG	AAATTTTCCAGTTTGCGGTCG
TAGCCGGAGAGCCTACCAAAA	TAGCCAGAGAGCCTACCAAAA
ACCAAAAGGAGTTGGCAGCCA	ACCAAAAGGGGTTGGCAGCCA
CGGTAGCAAAACTACTGGGAG	CGGTAGCAGAACTACTGGGAG
TACTAGCCGGAGAGCCTACCA	TACTAGCCAGAGAGCCTACCA
AGGCTCTCCGGCTAGTATGCG	AGGCTCTCTGGCTAGTATGCG
CCCACTACTTTGGGATTGACC	CCCACTAGTTTGGGATTGACC
GGCGAATTTGTACAGATATCA	GGCAAATTTGTACAGATATCA
ATAAGTCTAACTATCTAAGTA	ATAGGTCTAACTATCTAAGTA
CGAGACTGTATACGACAATTA	CGATACTGTATACGACAATTA
TCAAAACGTCGCGGCTAGAAA	TCGAAACGTCGCGGCTAGAAA
GACTTATTCAGCCGGAGAACC	GACCTATTCAGCCGGAGAACC
AGAGAGGTGAGACCGAACTAA	TGAGAGGTGAGACCGAACTAA
CCCAGAAACAGACCCGCGCGG	ACCAGAAACAGACCCGCGCGG
AGAAAACGATCCACCCGCTAC	AGATAACGATCCACCCGCTAC
AAAGGGTGAGGATCCAGTACA	AAAGGGTGATGATCCAGTACA
CAATCCGTTCCACTGTGCCAC	CACTCCGTTCCACTGTGCCAC
AGTGTGACGCTCCTATCCGGC	AGTGTCACGCTCCTATCCGGC
AGAAAATCTGCGCTTGCTCCG	AGAAAATCAGCGCTTGCTCCG
GAGTCACAATGGAGACATCAC	GAGGCACAATGGAGACATCAC
AACTATACTGTGGGCTTGCGA	ATCTATACTGTGGGCTTGCGA
TGAATAGATCAGGGTTTGCCA	TGAATTGATCAGGGTTTGCCA
AATGAGTGCGGGCTTCGCATT	AATGAGTGCCGGCTTCGCATT
AGGGGGCCGCTGCAGCGCAAC	AGGTGGCCGCTGCAGCGCAAC
AATTTTATGGAGATGGGCGAA	ATTTTTATGGAGATGGGCGAA
AAAGGAGTTGGCAGCCATACA	AAAGGGGTTGGCAGCCATACA
AAAGTAGTGGGTCCTGAGACT	AAACTAGTGGGTCCTGAGACT
ACCCTCAAAGTACACGCTCCG	ACCCACAAAGTACACGCTCCG
TCCACACGAGACTGTATACGA	TCCACACGATACTGTATACGA
ATTGTACTCAGTGTGCAATCA	GTTGTACTCAGTGTGCAATCA
ACCGTCGCTATTAACTTTGCT	ACCGTCGCAATTAACTTTGCT
CTCGTGCTTCGAATGAGGACC	CTCGTGATTCGAATGAGGACC
AAATTCGCCCAAAGCACACCA	AAATTTGCCCAAAGCACACCA
ACCCTGATCTATTCAAACCAT	ACCCTGATCAATTCAAACCAT
CAGAAAATCAGCGCTTGCTCC	CAGAAAATCTGCGCTTGCTCC
CTTAGTGCGACAGGGTGTTTC	CTTAGTGCGTCAGGGTGTTTC
ACTGATACGCACCGACGGATG	ACTGAAACGCACCGACGGATG
CCTCATTTAACTTCAGGTTCC	CGTCATTTAACTTCAGGTTCC
ATTATAAGCTACAGAAATCCA	ATTATCAGCTACAGAAATCCA
AGGAGCGTCACACTGGAATAT	AGGAGCGTGACACTGGAATAT
AGGGACCATGACCAAGATGTG	AGGTACCATGACCAAGATGTG
GCAGACTTCGTAAGAAAATAA	GCAGACTGCGTAAGAAAATAA
CATTGTGACTCGGTACCAGCC	CATTGTGCCTCGGTACCAGCC
ACCCTTTTTTGGGGGAGTCTC	ACCCTCTTTTGGGGGAGTCTC
GTTAGCAGTAATAAACTCATA	GATAGCAGTAATAAACTCATA
GGTGTATTCCTAGGGCGATAA	GGTGTGTTCCTAGGGCGATAA
AGTTTCATCTCAACTGAAGCC	ATTTTCATCTCAACTGAAGCC
CGATTATCAAAACGTCGCGGC	CGATTATCGAAACGTCGCGGC
AGTAGTTCTGCTACCGTATAG	AGTAGTTTTGCTACCGTATAG
CCCGTCCGTCCAATACGACCG	CCAGTCCGTCCAATACGACCG
AACCCTTTTTTGGGGGAGTCT	AACCCTCTTTTGGGGGAGTCT
ATATGCTTATCCGGTTATATG	ATGTGCTTATCCGGTTATATG
GATCCCCCCCCCTAACCTGTA	GATCCCACCCCCTAACCTGTA
AAAACGATCCACCCGCTACGC	ATAACGATCCACCCGCTACGC
ATTCCTAGGGCGATAACGAGA	GTTCCTAGGGCGATAACGAGA
AATTTGAGAGAGATTCCTTTA	AATATGAGAGAGATTCCTTTA
CAGACTGCGTAAGAAAATAAC	CAGACTTCGTAAGAAAATAAC
ACCCACTACTTTGGGATTGAC	ACCCACTAGTTTGGGATTGAC
ATATTATAAGCTACAGAAATC	ATATTATCAGCTACAGAAATC
CAGTAGTTCTGCTACCGTATA	CAGTAGTTTTGCTACCGTATA
ACGAGTTAGCAGTAATAAACT	ACGAGATAGCAGTAATAAACT
ATTTATCGCCTTTTACTCCTA	GTTTATCGCCTTTTACTCCTA
CCAGCTTTTAAATGGACGCAC	CCAGCTTTTTAATGGACGCAC
GACTAGGGACCATGACCAAGA	GACTAGGTACCATGACCAAGA
TTCGCATTAGTTTCATCTCAA	TTCGCATTATTTTCATCTCAA
AGTACAACAATGGCGTGTGTA	AGTACAATAATGGCGTGTGTA
GCCCAAACGTGAGAGGTGAGA	GCCCAAACGAGAGAGGTGAGA
GATTCATCCTTACCCTAAGTA	GATTCCTCCTTACCCTAAGTA
CGCGTGTACCCGCACTATGGC	CACGTGTACCCGCACTATGGC
CACCTCTCACGTTTGGGCGCC	CACCTCTCTCGTTTGGGCGCC
AGGTAAGTGTTTGAGTCCGCC	AGGTAAATGTTTGAGTCCGCC
CTGATTTTCTGACACGACCGA	CAGATTTTCTGACACGACCGA
GTACAAATTCGCCCAAAGCAC	GTACAAATTTGCCCAAAGCAC
TCCCCGTCACAATTGTCACGA	TCCCCGTCCCAATTGTCACGA
ATCCCCCCCCCTAACCTGTAA	ATCCCACCCCCTAACCTGTAA
ACAAATTTGCCCAAAGCACAC	ACAAATTCGCCCAAAGCACAC
CCCAAAAAAGGGTTCGCGATC	CCCAAAAGAGGGTTCGCGATC
ATTACTTGGACAGAACTTTAG	ATTACTTTGACAGAACTTTAG
GGAGACCCAGTCCGTCCAATA	GGAGACCCCGTCCGTCCAATA
GTGAGCATTGGCACCGCTAAC	GTGAGCATTAGCACCGCTAAC
GACGGACTGGGTCTCCCGATA	GACGGACGGGGTCTCCCGATA
AGATATACGTCCCAACGGCCC	ACATATACGTCCCAACGGCCC
CGTCGGTCCCAGAAACAGACC	CGTCGGTACCAGAAACAGACC
CACCGCTAATCTCGCAAGCCC	CACCGCTAACCTCGCAAGCCC
CCACCCTCTCAACCATCAACC	CAACCCTCTCAACCATCAACC
AGTTAGACTTATTCAGCCGGA	AGTTAGACCTATTCAGCCGGA
ACTCAAACACTTACCTTGCCA	ACTCAAACATTTACCTTGCCA
CCAAGTAATTGTCGTATACAG	CAAAGTAATTGTCGTATACAG
ATCCGACTAGAGTAGCAAGAA	ATCCGACTCGAGTAGCAAGAA
ACCACGTGTACCCGCACTATG	ACCGCGTGTACCCGCACTATG
ATACGATACTCAATCACCTGA	ATACGATACCCAATCACCTGA
TCGCTATTAACTTTGCTTTCA	TCGCAATTAACTTTGCTTTCA
GCGTCCATTTAAAAGCTGGAC	GCGTCCATTAAAAAGCTGGAC
CACACTGGAATATCGGGAGAC	GACACTGGAATATCGGGAGAC
ACCACCCTCTCAACCATCAAC	ACAACCCTCTCAACCATCAAC
CTGCGTACCGAATGTAACGTC	CTACGTACCGAATGTAACGTC
GGTATTCAGATATACGTCCCA	GGTATTCACATATACGTCCCA
AGTTAGGTTGGCGGTTCCTCA	AGTTAGGGTGGCGGTTCCTCA
AGTATGCGATGAGTTGCACCG	AGTATGCGACGAGTTGCACCG
CACTAGTTTGGGATTGACCAG	CACTACTTTGGGATTGACCAG
CTGAATAAGTCTAACTATCTA	CTGAATAGGTCTAACTATCTA
AGTTCGCGGTCTCTTGTTACA	AGTTCGCGATCTCTTGTTACA
ACGGTAGCAAAACTACTGGGA	ACGGTAGCAGAACTACTGGGA
GATGAATGACACTTGTCTGAC	GATGAATTACACTTGTCTGAC
AAGAGGGTTCGCGATCAAACA	AAAAGGGTTCGCGATCAAACA
TCGTTTTCTTGAACATTCCCA	TCGTTATCTTGAACATTCCCA
CAAAAGGAGTTGGCAGCCATA	CAAAAGGGGTTGGCAGCCATA
AACACCCTGTCGCACTAAGTA	AACACCCTGACGCACTAAGTA
AAGCATATAAGAGCACGCTGA	AAGCACATAAGAGCACGCTGA
TGAATAAGTCTAACTATCTAA	TGAATAGGTCTAACTATCTAA
GCAGGGTAAACGCGGTCGCCA	GCAGGGGAAACGCGGTCGCCA
CGACTGACTTGTATTCTAGAC	CGACTGACTCGTATTCTAGAC
ACTTATTCAGCCGGAGAACCG	ACCTATTCAGCCGGAGAACCG
GGCTTCGCAGACGACTCTTTA	GACTTCGCAGACGACTCTTTA
GGTGAGGATCCAGTACACTGA	GGTGATGATCCAGTACACTGA
AGGTTGGCGGTTCCTCAACTA	AGGGTGGCGGTTCCTCAACTA
GACGAATCGAATGGCCGGCCC	GACGATTCGAATGGCCGGCCC
TAGGAGCGTCACACTGGAATA	TAGGAGCGTGACACTGGAATA
ATCTGCGCTTGCTCCGGTCCA	ATCAGCGCTTGCTCCGGTCCA
AAAGGACTTCGCAGACGACTC	AAAGGGCTTCGCAGACGACTC
GAGGAATCGGAAATCGTGGGA	GATGAATCGGAAATCGTGGGA
AGTTTTGCTACCGTATAGTCA	AGTTCTGCTACCGTATAGTCA
GACCCAGTCCGTCCAATACGA	GACCCCGTCCGTCCAATACGA
ACTGGATCCTCACCCTTTTCA	ACTGGATCATCACCCTTTTCA
CCAAAAAAGGGTTCGCGATCA	CCAAAAGAGGGTTCGCGATCA
GTGTATTCCTAGGGCGATAAC	GTGTGTTCCTAGGGCGATAAC
CATTGGCACCGCTAACCTCGC	CATTAGCACCGCTAACCTCGC
GACAAGTGTCATTCATCCCAC	GACAAGTGTAATTCATCCCAC
AAGCTACAGAAATCCAGCAAG	CAGCTACAGAAATCCAGCAAG
ACAGTATCGTGTGGACAGGGG	ACAGTCTCGTGTGGACAGGGG
CGATACTCAATCACCTGATCC	CGATACCCAATCACCTGATCC
AGAACGTCATTTAACTTCAGG	AGAACCTCATTTAACTTCAGG
AGTCCGTCCAATACGACCGAC	CGTCCGTCCAATACGACCGAC
GGATGAATGACACTTGTCTGA	GGATGAATTACACTTGTCTGA
AGGATGAATCGGAAATCGTGG	AGGAGGAATCGGAAATCGTGG
AAGGGGGCCGCTGCAGCGCAA	AAGGTGGCCGCTGCAGCGCAA
CTCACGTTTGGGCGCCCGTAC	CTCTCGTTTGGGCGCCCGTAC
AGGGTAAACGCGGTCGCCATA	AGGGGAAACGCGGTCGCCATA
GCCACCCTAACTACACACGCC	GCCAACCTAACTACACACGCC
ACTAGGGACCATGACCAAGAT	ACTAGGTACCATGACCAAGAT
TCTCGAGCAGGGTCCTCCGCA	TCACGAGCAGGGTCCTCCGCA
ACAATGGCGTGTGTAGTTAGG	ATAATGGCGTGTGTAGTTAGG
AAAACTACTGGGAGGGGGGGG	AGAACTACTGGGAGGGGGGGG
ATCTCGCAAGCCCACAGTATA	ACCTCGCAAGCCCACAGTATA
AGAGGGTTCGCGATCAAACAC	AAAGGGTTCGCGATCAAACAC
CAAAACGTCGCGGCTAGAAAC	CGAAACGTCGCGGCTAGAAAC
CGATGAGTTGCACCGCTAAGA	CGACGAGTTGCACCGCTAAGA
TGAGACCGTGGAGTCCTTGCA	TGAGGCCGTGGAGTCCTTGCA
CGTAGAGGGAACTTCTCACGA	CGCAGAGGGAACTTCTCACGA
GTAATTCTAAGCACTATGTTA	GTAATTATAAGCACTATGTTA
ATTAGGACGCGAGCTGCGACA	ATAAGGACGCGAGCTGCGACA
AAGGAGTTGGCAGCCATACAT	AAGGGGTTGGCAGCCATACAT
CTCGAGTAGCAAGAATCCCCC	CTAGAGTAGCAAGAATCCCCC
CCCTGTCGCACTAAGTACGCG	CCCTGACGCACTAAGTACGCG
GACTAGAGTAGCAAGAATCCC	GACTCGAGTAGCAAGAATCCC
CCGTCACAATTGTCACGAGCA	CCGTCCCAATTGTCACGAGCA
CCTTATATTATCAGCTACAGA	CCTAATATTATCAGCTACAGA
GGGGGCCGCTGCAGCGCAACC	GGTGGCCGCTGCAGCGCAACC
CGTCACACTGGAATATCGGGA	CGTGACACTGGAATATCGGGA
AAATGTTTGAGTCCGCCGTCG	AAGTGTTTGAGTCCGCCGTCG
ATAGCGACGGTATTAGGGTGG	ATTGCGACGGTATTAGGGTGG
AATCTCGCAAGCCCACAGTAT	AACCTCGCAAGCCCACAGTAT
ACATAAGAGCACGCTGAAGAC	ATATAAGAGCACGCTGAAGAC
CCCTTTTTTGGGGGAGTCTCC	CCCTCTTTTGGGGGAGTCTCC
TAAGCTACAGAAATCCAGCAA	TCAGCTACAGAAATCCAGCAA
CAAATTTGCCCAAAGCACACC	CAAATTCGCCCAAAGCACACC
ACCTCATTTAACTTCAGGTTC	ACGTCATTTAACTTCAGGTTC
ATTGTAAACCATGCATAAGAC	ATTATAAACCATGCATAAGAC
CAGTCTCGTGTGGACAGGGGC	CAGTATCGTGTGGACAGGGGC
AAGGGTGAGGATCCAGTACAC	AAGGGTGATGATCCAGTACAC
AGACTAGGGACCATGACCAAG	AGACTAGGTACCATGACCAAG
AGTGCTCCCCCCCCCCTCCCA	ATTGCTCCCCCCCCCCTCCCA
AATCCGTTCCACTGTGCCACG	ACTCCGTTCCACTGTGCCACG
AGGGTGGTTACCCCTAGTTGA	AGGGTTGTTACCCCTAGTTGA
ATAAAAATTTCCAGTTTGCGG	ATAAAATTTTCCAGTTTGCGG
GAATGACACTTGTCTGACATA	GAATTACACTTGTCTGACATA
TACCATGACCAAGATGTGCCA	GACCATGACCAAGATGTGCCA
GAGCACTCCGTTCCACTGTGC	GAGCAATCCGTTCCACTGTGC
AGATCGCGAACTGATCGCTTC	AGACCGCGAACTGATCGCTTC
AAAAAAGGGTTCGCGATCAAA	AAAAGAGGGTTCGCGATCAAA
GTGCCAATGCTCACCCAGGGA	GTGCTAATGCTCACCCAGGGA
GCCAATGCTCACCCAGGGAGC	GCTAATGCTCACCCAGGGAGC
ATTATCAAAACGTCGCGGCTA	ATTATCGAAACGTCGCGGCTA
AACGGAGTGCTCCCCCCCCCC	AACGGATTGCTCCCCCCCCCC
AACCCTCAAAGTACACGCTCC	AACCCACAAAGTACACGCTCC
CCGCGGATATCCCTCGTGTCG	CCGCGGTTATCCCTCGTGTCG
ACGTTTTGATAATCGATCAGC	ACGTTTCGATAATCGATCAGC
AGTTAGCAGTAATAAACTCAT	AGATAGCAGTAATAAACTCAT
CCGCCAACCTAACTACACACG	CCGCCACCCTAACTACACACG
AAAGAACTTCTTTGCACTATG	AAGGAACTTCTTTGCACTATG
ACCGAGTCACAATGGAGACAT	ACCGAGGCACAATGGAGACAT
CCGTCCGTCCAATACGACCGA	CAGTCCGTCCAATACGACCGA
CTTGTATTCTAGACAGGTGAC	CTCGTATTCTAGACAGGTGAC
AAAAGAACTTCTTTGCACTAT	AAAGGAACTTCTTTGCACTAT
AGCGCAGATTTTCTGACACGA	AGCGCTGATTTTCTGACACGA
AATATTAGGACGCGAGCTGCG	AATATAAGGACGCGAGCTGCG
ATGCGATGAGTTGCACCGCTA	ATGCGACGAGTTGCACCGCTA
ACGGATTGCTCCCCCCCCCCT	ACGGAGTGCTCCCCCCCCCCT
GTGACGGGGAGTAAAGAACCA	GGGACGGGGAGTAAAGAACCA
CAACAATGGCGTGTGTAGTTA	CAATAATGGCGTGTGTAGTTA
GGATCCAGTACACTGAAAGCA	TGATCCAGTACACTGAAAGCA
CTACTTTGGGATTGACCAGCC	CTAGTTTGGGATTGACCAGCC
ATAAGCTACAGAAATCCAGCA	ATCAGCTACAGAAATCCAGCA
AACAATGGCGTGTGTAGTTAG	AATAATGGCGTGTGTAGTTAG
AAAATTTTATGGAGATGGGCG	AAATTTTTATGGAGATGGGCG
TACTCGTGCTTCGAATGAGGA	TACTCGTGATTCGAATGAGGA
ATGAATTACACTTGTCTGACA	ATGAATGACACTTGTCTGACA
AAACGTGAGAGGTGAGACCGA	AAACGAGAGAGGTGAGACCGA
ACAAGTGTCATTCATCCCACT	ACAAGTGTAATTCATCCCACT
AGATGAAACTAATGCGAAGCC	AGATGAAAATAATGCGAAGCC
ATTGTGCCTCGGTACCAGCCG	ATTGTGACTCGGTACCAGCCG
AGCATTGGCACCGCTAACCTC	AGCATTAGCACCGCTAACCTC
GGCAGACTGCGTAAGAAAATA	GGCAGACTTCGTAAGAAAATA
GCATTTATCGCCTTTTACTCC	GCGTTTATCGCCTTTTACTCC
ACCTCTCACGTTTGGGCGCCC	ACCTCTCTCGTTTGGGCGCCC
GTTAGGGTGGCGGTTCCTCAA	GTTAGGTTGGCGGTTCCTCAA
ATGAGTTGCACCGCTAAGAGC	ACGAGTTGCACCGCTAAGAGC
AGCGTCACACTGGAATATCGG	AGCGTGACACTGGAATATCGG
ATGAATCGGAAATCGTGGGAG	AGGAATCGGAAATCGTGGGAG
ACAGGTTTTCGCGCGCTGCTA	ACCGGTTTTCGCGCGCTGCTA
TTGCTACTCTAGTCGGATAAA	TTGCTACTCGAGTCGGATAAA
GCGTCAGGGTGTTTCTCTGCC	GCGACAGGGTGTTTCTCTGCC
CCTTTTTTGGGGGAGTCTCCC	CCTCTTTTGGGGGAGTCTCCC
CGACTAGAGTAGCAAGAATCC	CGACTCGAGTAGCAAGAATCC
ACTGGGTCTCCCGATATTCCA	ACGGGGTCTCCCGATATTCCA
GTCCTAATATTATCAGCTACA	GTCCTTATATTATCAGCTACA
CATGAACCACCAACCTGGTGG	CATCAACCACCAACCTGGTGG
ACGAGAGAGGTGAGACCGAAC	ACGTGAGAGGTGAGACCGAAC
ATTGTTGTACTCAGTGTGCAA	ATTATTGTACTCAGTGTGCAA
CTTTTGACTTGGAGGATCTCC	CCTTTGACTTGGAGGATCTCC
AGGTTTTCGCGCGCTGCTACG	CGGTTTTCGCGCGCTGCTACG
CAGACTAGGGACCATGACCAA	CAGACTAGGTACCATGACCAA
CCAGTGTGACGCTCCTATCCG	CCAGTGTCACGCTCCTATCCG
ATCAAAACGTCGCGGCTAGAA	ATCGAAACGTCGCGGCTAGAA
CTTATTCAGCCGGAGAACCGC	CCTATTCAGCCGGAGAACCGC
CTCAATCACCTGATCCTTGTA	CCCAATCACCTGATCCTTGTA
ACGAATCGAATGGCCGGCCCC	ACGATTCGAATGGCCGGCCCC
ATATCCGCGGCCGCGTAAGCC	ATAACCGCGGCCGCGTAAGCC
CATATAAGAGCACGCTGAAGA	CACATAAGAGCACGCTGAAGA
AAGTCTAACTATCTAAGTACA	AGGTCTAACTATCTAAGTACA
ACGTAGAGGGAACTTCTCACG	ACGCAGAGGGAACTTCTCACG
CCCTCAAAGTACACGCTCCGG	CCCACAAAGTACACGCTCCGG
ATTGGCACCGCTAACCTCGCA	ATTAGCACCGCTAACCTCGCA
AAATCTGCGCTTGCTCCGGTC	AAATCAGCGCTTGCTCCGGTC
TCAAAGTAATTGTCGTATACA	TCCAAGTAATTGTCGTATACA
CAGAACTACTGGGAGGGGGGG	CAAAACTACTGGGAGGGGGGG
CTCCTTACCCTAAGTAGTGTC	ATCCTTACCCTAAGTAGTGTC
CCGCGGATATATAGATTCGTA	CCGCGTATATATAGATTCGTA
CAAGGGGGCCGCTGCAGCGCA	CAAGGTGGCCGCTGCAGCGCA
CCCGTCACAATTGTCACGAGC	CCCGTCCCAATTGTCACGAGC
CCAAAGTAGTGGGTCCTGAGA	CCAAACTAGTGGGTCCTGAGA
AGACCCCGTCCGTCCAATACG	AGACCCAGTCCGTCCAATACG
AAGTTCTTTTGACTTGGAGGA	AAGTTCCTTTGACTTGGAGGA
AGGATCCAGTACACTGAAAGC	ATGATCCAGTACACTGAAAGC
CTACTCTAGTCGGATAAATCA	CTACTCGAGTCGGATAAATCA
CCGACTAGAGTAGCAAGAATC	CCGACTCGAGTAGCAAGAATC
CGTTTAGTAGCATCAATGTTC	CGGTTAGTAGCATCAATGTTC
ACAGACTCTTTCGATGAAAGG	ACAGTCTCTTTCGATGAAAGG
AAGAACTTCTTTGCACTATGG	AGGAACTTCTTTGCACTATGG
CTATCTCGTGACAGAGTACTC	CTAACTCGTGACAGAGTACTC
CTAGCCGGAGAGCCTACCAAA	CTAGCCAGAGAGCCTACCAAA
GTTTTCTTGAACATTCCCAAA	GTTATCTTGAACATTCCCAAA
CATTAGTTTCATCTCAACTGA	CATTATTTTCATCTCAACTGA
CCAACAATATACCAAGCGCGA	GCAACAATATACCAAGCGCGA
ATACTAGCCAGAGAGCCTACC	ATACTAGCCGGAGAGCCTACC
CGAAGCCCTTTCATCGAAAGA	CGAAGTCCTTTCATCGAAAGA
CTAGAATACAAGTCAGTCGTC	CTAGAATACGAGTCAGTCGTC
CAAAAGAACTTCTTTGCACTA	CAAAGGAACTTCTTTGCACTA
CTCGTGTGGACAGGGGCATAA	ATCGTGTGGACAGGGGCATAA
CATGTATAGCCAACAATATAC	CATGTATAGGCAACAATATAC
GTCTCACCGCGTGTACCCGCA	GTCTCACCACGTGTACCCGCA
GAGAGAGGTGAGACCGAACTA	GTGAGAGGTGAGACCGAACTA
TACCGAGTCACAATGGAGACA	TACCGAGGCACAATGGAGACA
CTACTGGCGGACCTCTCGAGC	CAACTGGCGGACCTCTCGAGC
ATTGGGACGGGGAGTAAAGAA	ATTGTGACGGGGAGTAAAGAA
GATACGCACCGACGGATGTAA	GAAACGCACCGACGGATGTAA
ATATATATTGTAAACCATGCA	ATATATATTATAAACCATGCA
ACGATACTCAATCACCTGATC	ACGATACCCAATCACCTGATC
AAGTCAAAAGAACTTCTTTGC	AAGTCAAAGGAACTTCTTTGC
ATCTCGTGACAGAGTACTCGG	AACTCGTGACAGAGTACTCGG
GTATAGCCAACAATATACCAA	GTATAGGCAACAATATACCAA
AGCTACTGATACGCACCGACG	AGCTACTGAAACGCACCGACG
GAAAATTTTATGGAGATGGGC	GAAATTTTTATGGAGATGGGC
AGTCTAACTATCTAAGTACAC	GGTCTAACTATCTAAGTACAC
GCGTCCTTATATTATCAGCTA	GCGTCCTAATATTATCAGCTA
CTGCGAAGTCCTTTCATCGAA	CTGCGAAGCCCTTTCATCGAA
AGTCAAAAGAACTTCTTTGCA	AGTCAAAGGAACTTCTTTGCA
ATATTGTAAACCATGCATAAG	ATATTATAAACCATGCATAAG
AGCACTCCGTTCCACTGTGCC	AGCAATCCGTTCCACTGTGCC
AACTGGAAAATTTTATGGAGA	AACTGGAAATTTTTATGGAGA
CCCCGTCACAATTGTCACGAG	CCCCGTCCCAATTGTCACGAG
TATTCAAACCATATGCTTGAA	AATTCAAACCATATGCTTGAA
CCTCTCACGTTTGGGCGCCCG	CCTCTCTCGTTTGGGCGCCCG
TGCGAAGTCCTTTCATCGAAA	TGCGAAGCCCTTTCATCGAAA
AGGGTGAGGATCCAGTACACT	AGGGTGATGATCCAGTACACT
CAGCTTTTAAATGGACGCACA	CAGCTTTTTAATGGACGCACA
ATGTGAATACCCACCGCGTGC	ATCTGAATACCCACCGCGTGC
CACGAGTTAGCAGTAATAAAC	CACGAGATAGCAGTAATAAAC
TTAGCAGTAATAAACTCATAA	ATAGCAGTAATAAACTCATAA
GCGTACCGAATGTAACGTCAA	ACGTACCGAATGTAACGTCAA
AGAGATCGCGAACTGATCGCT	AGAGACCGCGAACTGATCGCT
CTTGCCAGCGATGGCAAGGTA	CTTGCCAGCCATGGCAAGGTA
TAGAGGGAACTTCTCACGAGA	CAGAGGGAACTTCTCACGAGA
CAAACGTGAGAGGTGAGACCG	CAAACGAGAGAGGTGAGACCG
AGTTCTGTCAAAGTAATTGTC	AGTTCTGTCCAAGTAATTGTC
TCCGATTCCTCCTTACCCTAA	TCCGATTCATCCTTACCCTAA
GTCACGAGTTAGCAGTAATAA	GTCACGAGATAGCAGTAATAA
CGTTTTCTTGAACATTCCCAA	CGTTATCTTGAACATTCCCAA
GGAACGGAGTGCTCCCCCCCC	GGAACGGATTGCTCCCCCCCC
TAGACTTATTCAGCCGGAGAA	TAGACCTATTCAGCCGGAGAA
GGTCATGGTCCCTAGTCTGCA	GGTCATGGTACCTAGTCTGCA
CCCAAAGTAGTGGGTCCTGAG	CCCAAACTAGTGGGTCCTGAG
GCTTTTAAATGGACGCACAGA	GCTTTTTAATGGACGCACAGA
ATTGTTGGCTATACATGTCAA	ATTGTTGCCTATACATGTCAA
AGACTTATTCAGCCGGAGAAC	AGACCTATTCAGCCGGAGAAC
AATTTGCCCAAAGCACACCAC	AATTCGCCCAAAGCACACCAC
AGATTTTCTGACACGACCGAA	TGATTTTCTGACACGACCGAA
AGAAGTTCTTTTGACTTGGAG	AGAAGTTCCTTTGACTTGGAG
CCACACGATACTGTATACGAC	CCACACGAGACTGTATACGAC
ATTCTAAGCACTATGTTATTC	ATTATAAGCACTATGTTATTC
GTACCGAGTCACAATGGAGAC	GTACCGAGGCACAATGGAGAC
CCACCCTAACTACACACGCCA	CCAACCTAACTACACACGCCA
CCCCGTCCGTCCAATACGACC	CCCAGTCCGTCCAATACGACC
CGAGGTGTATTCCTAGGGCGA	CGAGGTGTGTTCCTAGGGCGA
CGCTGGCAAGTGTTGTCGGAA	GGCTGGCAAGTGTTGTCGGAA
AGGTGATTGAGTATCGTATTA	AGGTGATTGGGTATCGTATTA
GAGACCCAGTCCGTCCAATAC	GAGACCCCGTCCGTCCAATAC
GATATCCCTCGTGTCGTCCAA	GTTATCCCTCGTGTCGTCCAA
CGAGTTAGCAGTAATAAACTC	CGAGATAGCAGTAATAAACTC
CAAGAGACCGCGAACTGATCG	CAAGAGATCGCGAACTGATCG
CGAGTCACAATGGAGACATCA	CGAGGCACAATGGAGACATCA
CAAAAAAGGGTTCGCGATCAA	CAAAAGAGGGTTCGCGATCAA
ATGAACCACCAACCTGGTGGG	ATCAACCACCAACCTGGTGGG
AGCATATAAGAGCACGCTGAA	AGCACATAAGAGCACGCTGAA
CCATAAAAATTTCCAGTTTGC	CCATAAAATTTTCCAGTTTGC
GACTGGGTCTCCCGATATTCC	GACGGGGTCTCCCGATATTCC
ACTAGCCGGAGAGCCTACCAA	ACTAGCCAGAGAGCCTACCAA
TACAAATTTGCCCAAAGCACA	TACAAATTCGCCCAAAGCACA
AACCACCCTCTCAACCATCAA	AACAACCCTCTCAACCATCAA
AATTACTTTGACAGAACTTTA	AATTACTTGGACAGAACTTTA
AGCTTTTAAATGGACGCACAG	AGCTTTTTAATGGACGCACAG
TGAGGATCCAGTACACTGAAA	TGATGATCCAGTACACTGAAA
CTATTCAAACCATATGCTTGA	CAATTCAAACCATATGCTTGA
CATTTAAAAGCTGGACTGGAC	CATTAAAAAGCTGGACTGGAC
GTACGTAGAGGGAACTTCTCA	GTACGCAGAGGGAACTTCTCA
ATGAAAGGGCTTCGCAGACGA	ATGAAAGGACTTCGCAGACGA
GCAATCCGTTCCACTGTGCCA	GCACTCCGTTCCACTGTGCCA
ATGAGTGCGGGCTTCGCATTA	ATGAGTGCCGGCTTCGCATTA
AGGGATATCCGCGGCCGCGTA	AGGGATAACCGCGGCCGCGTA
TCAATCACCTGATCCTTGTAA	CCAATCACCTGATCCTTGTAA
CTACTGATACGCACCGACGGA	CTACTGAAACGCACCGACGGA
AGGGGTAACCACCCTCTCAAC	AGGGGTAACAACCCTCTCAAC
ATATTTAAGCAAACCCCGCTC	AAATTTAAGCAAACCCCGCTC
AAATTTGTACAGATATCAGGA	GAATTTGTACAGATATCAGGA
CTTTGGGCGAATTTGTACAGA	CTTTGGGCAAATTTGTACAGA
CAGTCTGCCGATATTGTCATC	AAGTCTGCCGATATTGTCATC
CACCCTGTCGCACTAAGTACG	CACCCTGACGCACTAAGTACG
CCCAAACGTGAGAGGTGAGAC	CCCAAACGAGAGAGGTGAGAC
GCAAGCGCTGATTTTCTGACA	GCAAGCGCAGATTTTCTGACA
CCATTATTGTACTCAGTGTGC	CCATTGTTGTACTCAGTGTGC
ATACAGTATCGTGTGGACAGG	ATACAGTCTCGTGTGGACAGG
CAAGCGCAGATTTTCTGACAC	CAAGCGCTGATTTTCTGACAC
TAATATTATCAGCTACAGAAA	TTATATTATCAGCTACAGAAA
GCGATAAATGCATAACAGGGA	GCGATAAACGCATAACAGGGA
AGTAGTGGGTCCTGAGACTGA	ACTAGTGGGTCCTGAGACTGA
ACGTATATCTGAATACCCACC	ACGTATATGTGAATACCCACC
TGCGATGAGTTGCACCGCTAA	TGCGACGAGTTGCACCGCTAA
CCTCTGCGTACCGAATGTAAC	CCTCTACGTACCGAATGTAAC
AGTTCTTTTGACTTGGAGGAT	AGTTCCTTTGACTTGGAGGAT
AAAACGTCGCGGCTAGAAACC	GAAACGTCGCGGCTAGAAACC
TCTCTCTCAAATTTAAGCAAA	TCTCTCTCATATTTAAGCAAA
GCAAGGTAAATGTTTGAGTCC	GCAAGGTAAGTGTTTGAGTCC
CATAACCCACAAAGTACACGC	CATAACCCTCAAAGTACACGC
CACACGAGACTGTATACGACA	CACACGATACTGTATACGACA
ACTGGAAATTTTTATGGAGAT	ACTGGAAAATTTTATGGAGAT
GACTGACTTGTATTCTAGACA	GACTGACTCGTATTCTAGACA
CCATCGCTGGCAAGTGTTGTC	CCATGGCTGGCAAGTGTTGTC
GATATCCGCGGCCGCGTAAGC	GATAACCGCGGCCGCGTAAGC
ATGGTTTACAATATATATGTG	ATGGTTTATAATATATATGTG
AGCAAGCGCTGATTTTCTGAC	AGCAAGCGCAGATTTTCTGAC
CACCTCGAAACTTCCCTGTTA	CACCTCGAATCTTCCCTGTTA
GACGTATATGTGAATACCCAC	GACGTATATCTGAATACCCAC
CATTCGAAGCACGAGTAACCG	CATTCGAATCACGAGTAACCG
CTTAAATATGAGAGAGATTCC	CTTAAATTTGAGAGAGATTCC
ACTCGTGCTTCGAATGAGGAC	ACTCGTGATTCGAATGAGGAC
GAACCCTCTTTTGGGGGAGTC	GAACCCTTTTTTGGGGGAGTC
GGCTCTCCGGCTAGTATGCGA	GGCTCTCTGGCTAGTATGCGA
GAACCGCCAACCTAACTACAC	GAACCGCCACCCTAACTACAC
TATTGTTGGCTATACATGTCA	TATTGTTGCCTATACATGTCA
CATAAAATTTTCCAGTTTGCG	CATAAAAATTTCCAGTTTGCG
AGTTAATAGCGACGGTATTAG	AGTTAATTGCGACGGTATTAG
ACGCCATTGTTGTACTCAGTG	ACGCCATTATTGTACTCAGTG
ACACCCTGACGCACTAAGTAC	ACACCCTGTCGCACTAAGTAC
CAAAGTAGTGGGTCCTGAGAC	CAAACTAGTGGGTCCTGAGAC
ATCCCAAAGTAGTGGGTCCTG	ATCCCAAACTAGTGGGTCCTG
ACTGACTTGTATTCTAGACAG	ACTGACTCGTATTCTAGACAG
AAGGTAAATGTTTGAGTCCGC	AAGGTAAGTGTTTGAGTCCGC
GACCCACTACTTTGGGATTGA	GACCCACTAGTTTGGGATTGA
GCAACTCATCGCATACTAGCC	GCAACTCGTCGCATACTAGCC
AAGAAGTTCTTTTGACTTGGA	AAGAAGTTCCTTTGACTTGGA
AATCGAATGGCCGGCCCCTTA	ATTCGAATGGCCGGCCCCTTA
CCCTGATCTATTCAAACCATA	CCCTGATCAATTCAAACCATA
CCAACTCCTTTTGGTAGGCTC	CCAACCCCTTTTGGTAGGCTC
AGTATCGTATTACGGCCTCCA	GGTATCGTATTACGGCCTCCA
CCAATTGTCACGAGCAGGGTC	ACAATTGTCACGAGCAGGGTC
ACAAGAGATCGCGAACTGATC	ACAAGAGACCGCGAACTGATC
CGACGTTTTGATAATCGATCA	CGACGTTTCGATAATCGATCA
AGAATACAAGTCAGTCGTCGG	AGAATACGAGTCAGTCGTCGG
ACGAAGTCTGCCGATATTGTC	ACGCAGTCTGCCGATATTGTC
CAAGGTAAATGTTTGAGTCCG	CAAGGTAAGTGTTTGAGTCCG
GTCGTCGGTACCAGAAACAGA	GTCGTCGGTCCCAGAAACAGA
AATTTTTATGGAGATGGGCGA	AAATTTTATGGAGATGGGCGA
CAGATATACGTCCCAACGGCC	CACATATACGTCCCAACGGCC
GGGATATCCGCGGCCGCGTAA	GGGATAACCGCGGCCGCGTAA
AAGGGCTTCGCAGACGACTCT	AAGGACTTCGCAGACGACTCT
CGCGATCTCTTGTTACATGAA	CGCGGTCTCTTGTTACATGAA
AAAATCTGCGCTTGCTCCGGT	AAAATCAGCGCTTGCTCCGGT
CATTGTTGTACTCAGTGTGCA	CATTATTGTACTCAGTGTGCA
GGATATCCCTCGTGTCGTCCA	GGTTATCCCTCGTGTCGTCCA
GCGCAGATTTTCTGACACGAC	GCGCTGATTTTCTGACACGAC
AATTTTCCAGTTTGCGGTCGC	AAATTTCCAGTTTGCGGTCGC
CCACTACTTTGGGATTGACCA	CCACTAGTTTGGGATTGACCA
TATTGTAAACCATGCATAAGA	TATTATAAACCATGCATAAGA
ATTAGTTTCATCTCAACTGAA	ATTATTTTCATCTCAACTGAA
CCATTGTGCCTCGGTACCAGC	CCATTGTGACTCGGTACCAGC
CGAGTAGCAAGAATCCCCCCA	AGAGTAGCAAGAATCCCCCCA
AAAATTTTCCAGTTTGCGGTC	AAAAATTTCCAGTTTGCGGTC
CACCCTCTCAACCATCAACCA	AACCCTCTCAACCATCAACCA
ACTCTAGTCGGATAAATCAAG	ACTCGAGTCGGATAAATCAAG
CGGTCCCAGAAACAGACCCGC	CGGTACCAGAAACAGACCCGC
AGCCCGCACTCATTAGGGAGA	AGCCGGCACTCATTAGGGAGA
GTCATGGTCCCTAGTCTGCAA	GTCATGGTACCTAGTCTGCAA
CTCGAATCTTCCCTGTTATGC	CTCGAAACTTCCCTGTTATGC
CGTCCTAATATTATCAGCTAC	CGTCCTTATATTATCAGCTAC
ACCCAGTCCGTCCAATACGAC	ACCCCGTCCGTCCAATACGAC
CAGTGTGACGCTCCTATCCGG	CAGTGTCACGCTCCTATCCGG
ATTCATCCTTACCCTAAGTAG	ATTCCTCCTTACCCTAAGTAG
ATCGCTGGCAAGTGTTGTCGG	ATGGCTGGCAAGTGTTGTCGG
AATAAGTCTAACTATCTAAGT	AATAGGTCTAACTATCTAAGT
AAGTAGTGGGTCCTGAGACTG	AACTAGTGGGTCCTGAGACTG
ACTACTTTGGGATTGACCAGC	ACTAGTTTGGGATTGACCAGC
ATAATATAAGGACGCGAGCTG	ATAATATTAGGACGCGAGCTG
TACTTTGTGGGTTATGCACTA	TACTTTGAGGGTTATGCACTA
TCACGAGATAGCAGTAATAAA	TCACGAGTTAGCAGTAATAAA
ACCGCGTTTACCCTGCGACGA	ACCGCGTTTCCCCTGCGACGA
TATCCGACTAGAGTAGCAAGA	TATCCGACTCGAGTAGCAAGA
GTTTCTGGGACCGACGACTGA	GTTTCTGGTACCGACGACTGA
GGTACCGAGGCACAATGGAGA	GGTACCGAGTCACAATGGAGA
GTATACAGTCTCGTGTGGACA	GTATACAGTATCGTGTGGACA
AATCAGCGCTTGCTCCGGTCC	AATCTGCGCTTGCTCCGGTCC
